Nivel_Ingresos,Estado_Siniestro,Cliente_ID,Antig√ºedad_Maxima,Saldo_Pendiente,Saldo_Pendiente_Seg,Puntaje_Morosidad1,Puntaje_Morosidad2,Puntaje_Morosidad3,Puntaje_Morosidad4,Puntaje_Morosidad5,Puntaje_Morosidad6,Morosidad_total,Siniestros1,Siniestros2,Siniestros3,Siniestros4,Siniestros5,Siniestros6,Siniestros_total
Medio_bajo,No_siniestro,94130,42,0,0,0,1,0,0,0,0,1,9,9,9,9,9,9,54
Medio_bajo,No_siniestro,17565,15,5485.37,0,1,2,1,0,0,2,6,69,68,65,47,33,15,297
Bajo,No_siniestro,624525,13,2274.38,0,2,1,0,2,3,3,11,42,40,43,42,41,33,241
Medio_bajo,No_siniestro,136621,33,482.14,0,0,0,0,0,0,0,0,40,40,40,40,40,40,240
Medio_bajo,Si_siniestro,512599,29,8.31,0,0,7,7,7,7,7,35,39,39,39,40,39,39,235
Bajo,Si_siniestro,640392,24,2722.24,0,3,3,2,1,0,3,12,42,40,39,37,36,40,234
Medio_bajo,No_siniestro,274290,42,8.94,0,0,0,0,0,0,0,0,37,38,38,39,38,38,228
Medio_bajo,No_siniestro,284947,2,1000,0,3,7,0,0,0,0,10,42,38,38,34,29,25,206
Medio_bajo,No_siniestro,36135,39,0.01,0,0,7,6,5,4,3,25,33,33,33,34,33,31,197
Bajo,No_siniestro,38993,23,155.44,0,4,3,4,2,2,2,17,36,35,34,32,30,28,195
Medio_bajo,No_siniestro,332609,140,287.06,0,0,0,0,1,1,2,4,30,30,31,31,33,33,188
Medio_bajo,No_siniestro,305257,3,400,0,4,7,7,0,0,0,18,34,33,33,31,29,27,187
Bajo,No_siniestro,731743,197,2688.5,0,0,0,0,0,0,0,0,29,29,29,29,29,29,174
Medio_bajo,No_siniestro,305902,55,0,0,0,0,0,0,0,0,0,41,37,30,23,22,15,168
Bajo,No_siniestro,346772,61,77.54,0,0,0,0,0,0,0,0,26,25,28,28,27,26,160
Medio_bajo,Si_siniestro,327535,23,1150.95,0,1,7,7,6,5,4,30,39,33,29,24,17,15,157
Medio_bajo,No_siniestro,229621,26,2881.96,0,4,7,7,7,7,6,38,32,29,26,25,23,19,154
Medio_bajo,No_siniestro,516703,83,1087.14,0,0,0,0,0,0,0,0,26,26,25,25,24,25,151
Bajo,Si_siniestro,53613,29,543.24,0,3,2,1,1,2,2,11,30,27,24,24,20,16,141
Bajo,No_siniestro,326062,53,435,0,1,1,1,0,0,0,3,25,24,23,22,23,23,140
Medio_bajo,No_siniestro,75312,12,3288.42,0,0,0,0,1,0,0,1,23,23,23,23,23,23,138
Medio_bajo,No_siniestro,240523,20,504.97,0,0,7,7,7,7,7,35,24,24,24,23,22,21,138
Medio_bajo,Si_siniestro,286707,24,12.81,0,0,7,7,7,7,7,35,23,23,23,23,23,23,138
Moderado,No_siniestro,535493,104,11578.18,218543.81,0,7,7,6,5,4,29,9,9,9,37,33,31,128
Medio_bajo,No_siniestro,449528,5,1805.79,0,6,7,7,6,5,0,31,20,20,25,23,21,18,127
Medio_bajo,Si_siniestro,694920,43,889.78,0,1,7,6,5,4,3,26,22,22,22,22,17,19,124
Bajo,No_siniestro,64155,87,1800.86,0,0,0,0,0,0,0,0,20,20,21,21,21,21,124
Bajo,No_siniestro,302801,55,419.85,0,0,0,0,0,0,0,0,23,23,21,20,19,17,123
Medio_bajo,Si_siniestro,596874,87,2267.56,0,3,3,5,4,1,2,18,27,23,19,17,18,14,118
Bajo,No_siniestro,379012,60,93.72,0,0,0,0,0,0,0,0,20,20,20,20,19,19,118
Medio_bajo,No_siniestro,51978,32,916.65,0,0,7,6,5,4,0,22,22,19,19,17,17,14,108
Bajo,No_siniestro,638559,95,567,0,0,0,0,0,0,0,0,18,18,18,18,18,18,108
Bajo,No_siniestro,84459,33,467.64,0,0,1,2,1,0,1,5,19,21,20,17,12,10,99
Medio_bajo,No_siniestro,88085,28,2644.94,0,4,3,2,2,2,2,15,24,18,15,14,14,13,98
Medio_bajo,Si_siniestro,162474,21,1817.61,0,3,3,2,1,2,1,12,22,20,16,15,13,10,96
Medio_bajo,No_siniestro,606039,0,0.07,0,0,0,0,0,0,0,0,16,17,16,14,14,17,94
Medio_bajo,No_siniestro,772351,39,5753.31,0,0,3,1,1,2,1,8,21,18,18,14,12,10,93
Bajo,Si_siniestro,631073,23,868.13,0,3,2,1,2,2,1,11,19,15,15,15,15,14,93
Bajo,No_siniestro,660411,56,246.36,0,0,0,0,0,0,0,0,15,15,15,16,16,15,92
Medio_alto,Si_siniestro,29259,130,1148.25,0,0,0,0,0,1,1,2,19,18,16,14,12,10,89
Bajo,No_siniestro,722907,21,1318.47,0,6,6,6,5,5,5,33,16,15,15,13,15,15,89
Bajo,No_siniestro,53804,45,378.99,0,0,1,0,1,0,1,3,20,18,17,13,10,10,88
Medio_bajo,No_siniestro,35384,55,721.65,0,0,0,0,0,0,0,0,0,0,22,22,22,21,87
Medio_bajo,Si_siniestro,438951,50,2357.69,0,3,7,7,7,7,7,38,14,13,16,15,14,14,86
Medio_bajo,No_siniestro,765302,34,52.51,0,0,0,0,0,0,0,0,14,14,14,14,15,15,86
Bajo,No_siniestro,559381,83,338.22,0,0,0,0,0,0,0,0,15,14,14,14,14,14,85
Bajo,No_siniestro,50406,83,398.78,0,0,0,0,1,3,3,7,16,16,14,15,13,10,84
Medio_bajo,Si_siniestro,336951,15,1059.24,0,3,3,3,3,2,3,17,16,15,14,14,11,11,81
Bajo,Si_siniestro,662716,15,458.47,0,3,3,3,3,3,3,18,14,14,14,14,12,11,79
Bajo,No_siniestro,621339,19,2780.23,0,1,1,1,1,1,1,6,16,16,13,11,11,11,78
Medio_bajo,Si_siniestro,643048,8,10982.54,0,3,2,2,1,1,1,10,41,27,5,3,0,0,76
Medio_bajo,No_siniestro,475289,52,0,0,0,0,0,0,0,0,0,13,13,13,13,12,12,76
Bajo,Si_siniestro,503670,40,727.75,0,3,2,3,2,2,2,14,15,14,14,11,11,11,76
Bajo,Si_siniestro,575926,7,5521.07,0,2,3,2,1,2,1,11,29,25,7,8,4,0,73
Medio_bajo,No_siniestro,219854,155,1980.66,0,0,0,0,0,0,0,0,12,12,12,12,12,12,72
Bajo,No_siniestro,564497,50,702.98,0,0,0,0,0,0,0,0,13,13,12,11,12,11,72
Medio_bajo,Si_siniestro,283611,12,7481.63,0,3,2,1,1,0,1,8,13,13,12,12,7,13,70
Bajo,No_siniestro,645458,23,1028.02,0,0,0,0,6,4,4,14,9,9,13,13,13,12,69
Bajo,No_siniestro,562273,18,1641.24,0,4,4,4,1,2,3,18,18,13,11,10,9,7,68
Moderado,No_siniestro,258750,49,1482.2,0,0,0,0,0,0,0,0,11,11,11,11,11,11,66
Medio_bajo,No_siniestro,422482,92,3383.07,0,0,1,0,0,0,0,1,14,11,12,11,11,7,66
Medio_bajo,Si_siniestro,141676,49,1660.92,0,2,0,1,1,2,1,7,19,19,12,8,4,3,65
Medio_bajo,No_siniestro,672789,46,0,0,0,0,0,0,0,0,0,10,10,10,11,11,11,63
Medio,No_siniestro,177002,26,469.66,0,3,4,3,3,2,3,18,14,13,11,11,7,5,61
Bajo,No_siniestro,83514,28,301.18,16604.72,1,0,0,3,2,1,7,12,11,10,9,10,9,61
Medio_bajo,Si_siniestro,155251,23,813.46,0,2,2,2,2,2,2,12,13,11,10,10,9,7,60
Medio_bajo,Si_siniestro,521271,47,735.41,0,0,7,7,7,6,5,32,14,10,9,9,9,9,60
Bajo,No_siniestro,472023,94,1056.56,0,1,0,0,0,1,1,3,0,12,12,12,12,12,60
Bajo,No_siniestro,116358,15,2010.13,0,6,5,4,5,3,3,26,16,12,11,8,7,6,60
Medio_bajo,No_siniestro,416996,15,8220.2,0,5,4,3,2,1,0,15,17,16,13,10,1,2,59
Bajo,No_siniestro,429668,99,0,0,0,0,0,0,4,3,7,7,7,7,11,15,12,59
Medio_bajo,No_siniestro,732074,0,1.35,0,0,0,0,0,0,0,0,13,11,11,10,8,5,58
Bajo,Si_siniestro,310853,50,0.2,0,0,7,7,7,7,7,35,12,11,10,10,8,7,58
Bajo,Si_siniestro,182019,40,785.57,0,0,0,0,1,0,2,3,11,11,11,8,9,7,57
Bajo,No_siniestro,248706,18,3564.03,0,0,0,0,0,0,0,0,11,11,10,9,8,7,56
Bajo,No_siniestro,704891,20,0,0,0,7,7,7,7,4,32,7,7,7,12,12,11,56
Medio_bajo,No_siniestro,285827,7,4772.52,0,4,3,2,1,1,0,11,23,21,11,0,0,0,55
Bajo,Si_siniestro,556341,10,1226.18,0,1,1,0,0,0,0,2,14,12,10,10,7,1,54
Medio_alto,No_siniestro,157021,163,2111.38,0,5,4,3,2,3,2,19,9,9,10,8,8,8,52
Bajo,No_siniestro,364321,11,208.14,0,6,7,7,7,6,5,38,9,9,9,7,10,8,52
Bajo,No_siniestro,556949,20,1495.65,0,2,2,2,2,2,2,12,10,10,9,9,7,7,52
Bajo,No_siniestro,572442,31,0,0,0,0,0,0,0,0,0,10,10,9,9,8,6,52
Medio_bajo,No_siniestro,438896,24,707.12,0,5,4,5,4,3,2,23,10,11,11,8,6,5,51
Bajo,No_siniestro,150182,45,0,0,0,7,7,7,7,7,35,8,8,8,8,9,10,51
Medio_bajo,Si_siniestro,544474,24,1983.18,0,2,7,7,7,7,7,37,10,7,11,11,5,5,49
Bajo,Si_siniestro,680584,11,2104.08,0,3,2,3,2,1,1,12,7,7,15,7,6,7,49
Medio_bajo,Si_siniestro,614360,40,143.6,0,2,1,0,0,0,0,3,8,8,8,8,8,8,48
Bajo,No_siniestro,20978,20,916.39,0,0,0,0,0,0,0,0,8,8,8,8,8,8,48
Medio_bajo,No_siniestro,502733,29,0,0,0,0,0,0,0,0,0,0,10,10,9,9,9,47
Bajo,Si_siniestro,222887,15,3896.85,0,3,3,2,3,2,3,16,11,9,9,7,6,5,47
Bajo,No_siniestro,649082,10,1207.96,0,0,0,0,0,0,0,0,9,9,8,7,7,7,47
Medio_alto,Si_siniestro,405577,81,11247.04,0,3,2,1,1,0,1,8,10,9,9,7,7,4,46
Bajo,No_siniestro,318839,1,2451.5,0,1,0,0,0,0,0,1,0,0,12,11,12,11,46
Bajo,No_siniestro,445995,13,391.7,0,4,3,2,1,0,0,10,9,9,10,8,8,2,46
Medio,Si_siniestro,53095,78,117.81,0,1,0,2,1,1,0,5,7,7,7,8,8,8,45
Moderado,No_siniestro,154505,27,8320.53,0,4,7,7,7,7,6,38,7,6,5,10,9,7,44
Medio_bajo,Si_siniestro,94161,9,5813.89,0,3,2,1,2,1,1,10,18,11,8,7,0,0,44
Medio_bajo,Si_siniestro,427999,35,2738.41,0,0,0,0,0,0,0,0,8,10,9,8,5,4,44
Medio_bajo,No_siniestro,614752,25,0,0,0,7,7,7,6,5,32,8,6,10,8,7,5,44
Medio_bajo,No_siniestro,753930,42,3350.16,0,5,4,3,3,3,2,20,11,9,9,9,3,3,44
Bajo,No_siniestro,608823,18,1730.48,0,2,1,1,1,1,0,6,12,9,7,6,5,5,44
Moderado,Si_siniestro,217588,169,20025.35,90678.55,2,1,1,0,0,0,4,15,12,7,4,3,2,43
Medio_bajo,Si_siniestro,395428,33,740.4,0,0,0,1,0,1,2,4,7,7,8,7,7,7,43
Bajo,Si_siniestro,577332,16,824,0,1,2,4,3,2,2,14,9,10,7,7,6,4,43
Bajo,No_siniestro,7382,17,1586.51,0,0,0,0,0,0,0,0,8,8,8,7,6,5,42
Medio_bajo,Si_siniestro,370758,45,2902.93,0,0,0,0,0,0,0,0,7,7,7,12,8,0,41
Bajo,No_siniestro,140929,45,2489.83,0,3,3,2,2,2,2,14,10,9,8,6,5,3,41
Moderado,Si_siniestro,587950,40,0.41,0,0,0,0,2,1,0,3,5,5,5,5,4,16,40
Medio,Si_siniestro,576523,10,1960.51,0,3,4,3,2,1,0,13,14,10,9,7,0,0,40
Bajo,No_siniestro,355752,15,1084.06,0,5,4,3,2,1,1,16,12,9,8,6,3,2,40
Medio_bajo,Si_siniestro,525668,31,4227,0,3,3,2,1,2,2,13,8,7,7,6,6,5,39
Medio_bajo,No_siniestro,558083,25,123.26,0,0,0,0,0,0,0,0,7,7,7,7,4,7,39
Medio,Si_siniestro,116292,12,1987.31,0,2,3,3,3,2,1,14,13,9,7,5,4,1,39
Medio,Si_siniestro,447128,18,368.56,0,0,2,1,0,0,0,3,19,19,1,0,0,0,39
Bajo,Si_siniestro,302078,16,653.84,0,3,3,2,1,2,4,15,7,7,6,6,6,7,39
Bajo,No_siniestro,368498,22,473.74,0,0,1,1,0,0,0,2,9,7,7,6,6,4,39
Bajo,Si_siniestro,502298,18,600.67,0,2,3,2,1,4,6,18,8,7,6,6,6,6,39
Bajo,No_siniestro,780104,19,1549.61,0,0,0,0,0,2,2,4,5,8,8,9,5,4,39
Moderado,No_siniestro,219149,91,17855.19,93282.28,0,0,0,0,0,1,1,8,7,6,6,5,6,38
Bajo,No_siniestro,142922,86,378.59,0,1,0,0,0,0,0,1,7,7,6,6,6,6,38
Bajo,No_siniestro,764710,43,262.05,0,0,0,0,0,0,1,1,6,6,6,6,7,7,38
Medio_bajo,No_siniestro,97435,9,14166.07,0,0,0,0,0,0,0,0,6,6,7,6,7,5,37
Medio_bajo,Si_siniestro,151934,9,10824.7,0,1,0,0,0,0,1,2,23,7,4,0,3,0,37
Bajo,No_siniestro,270977,20,278.93,0,3,3,2,2,2,2,14,4,5,4,4,11,9,37
Bajo,No_siniestro,651842,66,636.36,0,0,0,0,0,0,0,0,6,6,6,6,6,7,37
Bajo,No_siniestro,7574,14,427.01,0,6,5,4,3,2,1,21,8,8,7,6,6,2,37
Medio_bajo,No_siniestro,34578,175,393.73,0,0,0,0,0,0,0,0,6,6,6,6,6,6,36
Medio_bajo,No_siniestro,354960,44,282.24,0,1,1,1,1,1,1,6,6,6,6,6,6,6,36
Medio_bajo,No_siniestro,471811,94,1287.88,0,0,0,0,0,0,0,0,6,6,6,6,6,6,36
Medio_bajo,No_siniestro,690713,4,1980,0,5,7,7,7,0,0,26,5,5,8,6,6,6,36
Medio_alto,No_siniestro,226180,49,15936.3,28155.75,0,0,0,0,0,0,0,7,7,7,7,4,4,36
Bajo,Si_siniestro,221500,49,1058.34,0,3,3,2,2,2,1,13,7,6,6,6,6,5,36
Bajo,Si_siniestro,538663,11,647.29,0,2,3,2,2,2,2,13,7,7,7,7,5,3,36
Medio_bajo,Si_siniestro,551754,26,0.55,0,0,0,1,0,0,0,1,7,7,6,6,5,4,35
Medio_alto,No_siniestro,736465,12,6009.84,0,1,1,1,1,0,0,4,12,6,6,6,3,1,34
Bajo,Si_siniestro,248448,12,812.75,0,2,2,1,0,0,0,5,8,8,7,4,4,3,34
Bajo,Si_siniestro,507477,6,743.03,0,3,2,1,0,1,0,7,11,9,8,6,0,0,34
Bajo,Si_siniestro,771271,9,465.53,0,0,1,6,5,4,3,19,5,5,5,9,7,3,34
Bajo,No_siniestro,443184,11,785.7,0,4,3,3,2,2,3,17,7,8,7,5,4,3,34
Medio_bajo,No_siniestro,104213,36,1363.28,0,0,0,0,0,0,0,0,0,0,0,6,12,15,33
Medio_bajo,No_siniestro,155384,63,12449,0,0,0,0,0,0,0,0,6,6,5,5,6,5,33
Medio_bajo,No_siniestro,498588,18,701.37,0,0,0,0,0,0,0,0,11,7,7,5,2,1,33
Medio_bajo,Si_siniestro,723103,24,8913.05,0,3,7,6,5,4,3,28,7,8,8,4,4,2,33
Bajo,Si_siniestro,41124,11,1527.65,0,1,1,1,1,0,0,4,8,7,6,5,4,3,33
Bajo,No_siniestro,664344,21,707.67,0,0,0,0,0,0,0,0,6,6,5,6,5,5,33
Medio_bajo,No_siniestro,198496,55,1186.2,0,1,0,1,0,0,0,2,12,8,7,3,1,1,32
Medio_bajo,No_siniestro,788050,42,8618.68,0,4,3,3,2,1,1,14,11,7,7,3,2,2,32
Bajo,No_siniestro,658497,127,258.15,0,0,0,0,0,0,0,0,0,0,8,8,8,8,32
Medio_alto,No_siniestro,598656,24,0,0,0,7,7,7,7,7,35,4,5,5,5,5,7,31
Bajo,No_siniestro,472981,47,1359.96,0,0,0,0,0,0,0,0,4,3,3,8,6,7,31
Medio_bajo,Si_siniestro,230204,31,356.31,0,0,0,2,2,2,2,8,2,6,7,7,4,4,30
Medio_bajo,Si_siniestro,423168,8,7842.56,0,3,2,1,1,0,0,7,6,6,5,7,4,2,30
Medio_bajo,No_siniestro,53772,0,46.75,0,0,0,0,0,0,0,0,0,4,5,5,9,7,30
Medio_bajo,No_siniestro,80426,90,0,0,0,7,7,7,7,7,35,5,5,5,5,5,5,30
Medio_bajo,No_siniestro,242268,3,453.83,0,4,3,3,0,0,0,10,8,8,7,4,1,2,30
Bajo,No_siniestro,239904,56,1336.74,0,0,0,0,0,0,0,0,0,6,6,6,6,6,30
Bajo,No_siniestro,496439,7,887.16,0,0,2,1,0,1,0,4,7,6,6,4,5,2,30
Bajo,No_siniestro,667077,71,4508.81,0,0,0,0,0,0,0,0,5,5,5,5,5,5,30
Bajo,No_siniestro,402984,49,0,0,0,7,7,7,7,7,35,5,5,5,5,5,5,30
Medio_bajo,No_siniestro,137871,69,4673.33,0,0,1,0,0,0,0,1,5,5,5,5,6,3,29
Medio_bajo,Si_siniestro,421317,110,864.05,0,0,1,0,0,1,0,2,8,8,5,6,2,0,29
Medio,No_siniestro,54787,64,1591.01,0,0,7,6,5,4,3,25,4,5,5,5,5,5,29
Medio,No_siniestro,640487,1,188.31,0,0,0,0,0,0,0,0,0,0,7,6,7,9,29
Medio_bajo,Si_siniestro,290787,18,1100.43,0,2,2,1,0,0,0,5,7,5,4,4,4,4,28
Medio_bajo,Si_siniestro,525142,30,79.58,0,0,0,0,0,0,0,0,7,4,5,5,4,3,28
Medio_bajo,No_siniestro,700535,50,3329.71,0,4,5,4,3,2,1,19,9,9,6,2,1,1,28
Bajo,No_siniestro,109222,30,509.11,0,0,1,0,1,0,2,4,4,5,6,4,4,5,28
Medio_bajo,Si_siniestro,172459,22,1023.21,0,3,2,1,0,0,0,6,6,4,1,1,6,9,27
Bajo,Si_siniestro,293458,16,1179.41,0,3,2,1,0,1,1,8,8,5,4,4,4,2,27
Bajo,Si_siniestro,706196,31,152.48,0,3,2,2,2,2,1,12,5,5,5,4,4,4,27
Bajo,No_siniestro,301815,19,1647.16,0,5,4,3,2,1,0,15,8,6,8,3,2,0,27
Bajo,No_siniestro,683504,119,0,0,0,0,0,2,2,2,6,4,4,4,5,5,5,27
Medio_bajo,Si_siniestro,347978,29,1621.36,0,0,0,0,0,0,1,1,4,4,5,4,4,5,26
Medio_bajo,No_siniestro,706083,22,4496.68,0,1,1,4,3,2,2,13,3,3,7,5,4,4,26
Medio_alto,No_siniestro,73789,66,6942.33,77582.28,0,0,0,0,0,0,0,3,6,5,3,4,5,26
Medio_alto,No_siniestro,273152,47,14569.67,46322.02,0,0,0,0,0,0,0,4,5,5,5,4,3,26
Medio_alto,Si_siniestro,636867,12,20202,0,2,2,1,1,1,0,7,9,4,4,4,3,2,26
Bajo,Si_siniestro,74683,19,1547.21,0,3,2,1,2,3,2,13,6,4,4,5,4,3,26
Bajo,No_siniestro,191586,165,3368.43,0,1,1,1,1,1,1,6,7,5,5,3,3,3,26
Bajo,Si_siniestro,439322,14,724.07,0,2,2,1,1,2,1,9,5,5,3,4,5,4,26
Bajo,No_siniestro,522488,53,3353.37,0,5,4,3,2,1,2,17,5,6,4,4,4,3,26
Bajo,No_siniestro,540887,6,950.91,0,4,3,2,1,0,0,10,10,5,4,4,2,1,26
Bajo,No_siniestro,566643,27,3846.56,0,6,5,4,3,2,1,21,7,6,5,4,2,2,26
Moderado,No_siniestro,221608,88,546.9,0,0,0,4,3,2,2,11,3,3,6,5,4,4,25
Medio_bajo,No_siniestro,133772,21,1231.76,0,0,0,0,0,0,1,1,5,4,4,4,4,4,25
Medio_bajo,Si_siniestro,170418,6,1738.81,0,0,1,0,1,1,0,3,7,7,5,3,3,0,25
Medio_bajo,Si_siniestro,216615,93,1776.12,0,2,1,1,2,1,1,8,10,6,4,2,2,1,25
Medio_bajo,No_siniestro,683814,24,6067.27,0,0,0,0,0,0,0,0,6,6,5,4,2,2,25
Bajo,Si_siniestro,247589,8,824.71,0,0,3,2,2,1,2,10,7,8,6,4,0,0,25
Bajo,No_siniestro,342286,15,1768.38,0,1,1,1,1,1,1,6,6,5,5,4,4,1,25
Bajo,Si_siniestro,433059,12,1571.95,0,3,3,3,2,2,1,14,7,6,5,4,3,0,25
Bajo,Si_siniestro,498082,20,774.8,0,2,1,0,0,2,1,6,4,4,4,4,5,4,25
Bajo,No_siniestro,280819,59,0,0,0,7,7,7,7,7,35,5,4,5,4,3,4,25
Bajo,No_siniestro,679587,9,940.38,0,2,2,2,2,2,1,11,7,7,5,2,2,2,25
Medio_bajo,No_siniestro,523829,125,114.16,0,0,1,0,0,0,0,1,4,4,4,4,4,4,24
Medio_bajo,Si_siniestro,615092,12,1792.08,0,2,2,1,0,0,1,6,10,5,2,2,2,3,24
Medio_bajo,No_siniestro,707138,18,2352.8,0,0,0,0,0,0,0,0,4,4,4,4,4,4,24
Medio_bajo,No_siniestro,330746,10,142.27,0,0,0,0,1,0,0,1,6,5,4,4,3,2,24
Medio_bajo,No_siniestro,476109,22,0,0,0,0,0,0,0,2,2,4,4,4,4,3,5,24
Medio,No_siniestro,510886,49,5343.81,0,0,0,0,0,3,2,5,3,3,3,3,7,5,24
Bajo,No_siniestro,108721,25,2397.83,0,0,0,0,0,0,0,0,4,4,4,4,4,4,24
Bajo,Si_siniestro,481413,17,2016.57,0,2,2,2,2,3,2,13,6,5,5,3,3,2,24
Bajo,Si_siniestro,489012,30,1202.89,0,0,0,0,0,0,0,0,4,4,4,4,4,4,24
Bajo,No_siniestro,181546,14,543.17,0,5,4,3,2,1,0,15,8,7,6,3,0,0,24
Bajo,No_siniestro,691281,63,0,0,0,0,0,0,0,0,0,4,4,4,4,4,4,24
Medio_bajo,No_siniestro,64663,10,1910.83,0,0,0,0,0,0,0,0,12,7,2,2,0,0,23
Medio_bajo,No_siniestro,115656,36,478.78,0,0,2,1,1,0,0,4,4,4,5,4,3,3,23
Medio_bajo,Si_siniestro,155970,39,11403.07,0,3,3,2,1,0,0,9,9,7,3,1,2,1,23
Medio_bajo,Si_siniestro,216838,27,2322.18,0,3,3,2,2,2,1,13,7,7,5,2,1,1,23
Medio_bajo,Si_siniestro,245932,19,3769.01,0,0,0,0,0,1,0,1,3,4,4,4,4,4,23
Medio_bajo,Si_siniestro,475716,23,5829.56,0,3,2,1,0,3,2,11,9,4,4,0,4,2,23
Medio_bajo,No_siniestro,650029,40,3506.84,0,0,0,0,0,0,0,0,8,6,3,3,3,0,23
Medio_bajo,No_siniestro,664964,43,1192.75,0,0,0,0,0,0,0,0,4,4,4,4,4,3,23
Bajo,No_siniestro,110541,29,0.13,0,0,0,0,0,0,0,0,4,4,4,4,4,3,23
Bajo,No_siniestro,160452,53,100.21,0,0,6,5,4,5,3,23,2,7,5,4,3,2,23
Bajo,No_siniestro,434743,66,0,0,0,0,0,0,0,0,0,4,4,4,4,4,3,23
Medio_bajo,Si_siniestro,365679,14,1180.45,0,3,2,1,1,1,0,8,7,5,4,3,2,1,22
Medio_bajo,No_siniestro,366920,44,955.58,0,1,0,0,0,0,0,1,5,5,5,3,2,2,22
Medio_bajo,Si_siniestro,707912,12,658.01,0,3,2,2,2,1,2,12,7,7,3,2,2,1,22
Medio_alto,No_siniestro,757938,120,10371.17,37910.71,0,0,0,0,0,0,0,6,5,5,4,1,1,22
Bajo,No_siniestro,376424,22,828.42,0,4,3,2,1,2,1,13,5,5,4,3,3,2,22
Medio_bajo,No_siniestro,11618,132,1105.51,0,1,1,1,0,0,0,3,5,3,4,3,3,3,21
Medio_bajo,No_siniestro,73713,24,10.84,0,0,0,0,0,0,0,0,4,4,4,3,3,3,21
Medio_bajo,No_siniestro,116000,39,12112.59,0,0,0,1,0,1,1,3,5,6,6,2,1,1,21
Medio_bajo,No_siniestro,20049,0,0.08,0,0,0,0,0,0,0,0,0,4,4,5,4,4,21
Medio_bajo,No_siniestro,114903,20,1588.48,0,6,5,4,3,2,1,21,6,5,4,2,3,1,21
Medio_bajo,No_siniestro,333053,15,132.28,0,0,0,0,0,0,0,0,3,3,4,4,4,3,21
Medio_bajo,No_siniestro,706291,11,3565.12,0,4,3,2,3,2,1,15,7,7,2,2,2,1,21
Bajo,Si_siniestro,574580,40,785.49,0,1,0,1,0,2,1,5,4,5,3,6,2,1,21
Bajo,No_siniestro,649309,19,394.7,0,1,0,0,0,0,1,2,3,2,3,3,5,5,21
Bajo,Si_siniestro,649520,43,701.56,0,1,0,2,2,1,1,7,6,5,4,2,2,2,21
Bajo,No_siniestro,706959,13,2499.77,0,1,1,1,0,1,1,5,3,3,4,4,4,3,21
Bajo,Si_siniestro,710564,18,1630.16,0,2,1,0,0,1,0,4,6,6,3,2,2,2,21
Bajo,No_siniestro,117807,17,2982.15,0,5,5,5,4,3,2,24,6,5,4,3,2,1,21
Bajo,No_siniestro,314604,24,1907.76,0,0,0,2,3,2,2,9,3,3,4,5,3,3,21
Medio_bajo,Si_siniestro,224581,6,13525.13,0,1,1,0,0,0,0,2,11,7,2,0,0,0,20
Medio_bajo,No_siniestro,356794,21,1085.95,0,1,0,0,0,0,0,1,5,3,3,3,3,3,20
Medio_bajo,No_siniestro,154278,14,6238.49,0,0,3,2,1,0,1,7,5,5,4,3,2,1,20
Medio_alto,No_siniestro,292652,112,2638.39,28091.96,0,1,0,0,0,0,1,5,5,4,5,1,0,20
Bajo,Si_siniestro,325656,13,244.6,0,2,2,2,1,1,0,8,6,3,4,3,2,2,20
Bajo,Si_siniestro,370811,17,1032.68,0,0,0,0,0,0,0,0,3,3,4,4,4,2,20
Bajo,No_siniestro,432617,12,2136.17,0,0,1,2,1,1,1,6,3,2,3,5,4,3,20
Bajo,No_siniestro,284429,48,0,0,0,0,0,0,0,0,0,2,2,2,2,6,6,20
Moderado,No_siniestro,591761,109,805.43,0,0,0,0,0,0,0,0,1,4,4,3,3,4,19
Medio_bajo,Si_siniestro,571903,7,5888.17,0,1,0,0,0,0,0,1,7,5,3,3,1,0,19
Medio_bajo,No_siniestro,168270,42,1698.11,0,1,1,1,1,1,0,5,3,3,3,2,3,5,19
Bajo,Si_siniestro,165785,38,490.83,0,0,0,0,0,0,0,0,3,3,3,3,3,4,19
Bajo,No_siniestro,95412,47,0,0,0,0,0,0,0,0,0,4,3,3,3,3,3,19
Bajo,No_siniestro,528265,67,0,0,3,7,7,7,7,7,38,3,3,3,3,4,3,19
Bajo,No_siniestro,605343,25,119.85,0,2,2,2,2,2,2,12,1,3,4,4,4,3,19
Bajo,No_siniestro,623031,88,614.7,0,1,2,1,0,0,1,5,6,3,3,3,4,0,19
Medio_bajo,No_siniestro,16685,35,614.19,0,0,0,0,0,0,0,0,3,3,3,3,3,3,18
Medio_bajo,No_siniestro,95130,39,619.89,0,0,0,0,0,0,0,0,0,0,0,6,6,6,18
Medio_bajo,Si_siniestro,124287,8,1260.43,0,3,3,2,3,1,0,12,6,5,4,2,1,0,18
Medio_bajo,No_siniestro,135728,43,2560.9,0,0,0,2,1,0,1,4,1,3,8,4,2,0,18
Medio_bajo,No_siniestro,220063,33,1534.75,0,0,0,0,0,0,0,0,3,3,3,3,3,3,18
Medio_bajo,Si_siniestro,275000,49,229.88,0,3,3,2,1,4,3,16,3,3,3,2,4,3,18
Medio_bajo,No_siniestro,459079,58,20121.31,0,0,0,0,0,0,0,0,3,3,3,3,3,3,18
Medio_bajo,Si_siniestro,487478,20,277.65,0,1,0,1,3,2,1,8,4,3,2,5,2,2,18
Medio_bajo,No_siniestro,602704,162,953.92,0,1,0,0,0,1,1,3,2,2,2,3,5,4,18
Medio_bajo,No_siniestro,648082,20,797.06,0,0,0,0,0,0,0,0,6,4,2,2,2,2,18
Medio_bajo,Si_siniestro,790095,25,3218.91,0,3,7,7,7,7,7,38,4,3,3,4,2,2,18
Medio_bajo,No_siniestro,13949,145,0,0,0,0,0,0,0,0,0,3,3,3,3,3,3,18
Medio_bajo,No_siniestro,706514,47,0,0,0,0,0,0,0,0,0,0,0,5,5,4,4,18
Bajo,No_siniestro,53727,12,287.84,0,0,0,0,0,0,0,0,7,5,3,2,1,0,18
Bajo,Si_siniestro,78696,22,204.14,0,3,3,3,3,2,2,16,5,4,3,2,2,2,18
Bajo,No_siniestro,179227,33,945.19,0,0,0,0,0,0,0,0,3,3,3,3,3,3,18
Bajo,Si_siniestro,235079,21,1417.38,0,0,0,0,0,2,1,3,3,3,2,2,4,4,18
Bajo,Si_siniestro,247337,7,997.92,0,1,2,1,2,1,1,8,5,4,3,3,1,2,18
Bajo,No_siniestro,503089,86,0.28,0,0,0,0,0,0,0,0,3,3,3,3,3,3,18
Bajo,No_siniestro,540764,18,1812.4,0,0,0,0,0,0,0,0,8,2,2,2,2,2,18
Bajo,No_siniestro,638713,27,0.02,0,0,0,0,0,0,0,0,3,3,3,3,3,3,18
Bajo,No_siniestro,661344,117,991.97,0,0,0,0,0,0,0,0,3,3,3,3,3,3,18
Bajo,Si_siniestro,692670,43,2077.3,0,2,2,2,1,1,0,8,8,8,2,0,0,0,18
Bajo,Si_siniestro,718839,8,1806.5,0,3,2,3,3,3,2,16,4,4,4,3,2,1,18
Bajo,Si_siniestro,762213,9,1029.6,0,0,1,0,0,0,0,1,5,5,5,2,1,0,18
Bajo,No_siniestro,318007,49,112.94,0,0,0,0,0,0,0,0,3,3,3,3,3,3,18
Bajo,No_siniestro,429932,26,85.45,0,0,0,0,0,0,0,0,3,3,3,3,3,3,18
Bajo,No_siniestro,706991,4,1189.19,0,0,0,0,0,0,0,0,6,6,3,1,1,1,18
Medio_bajo,Si_siniestro,52473,9,5905.46,0,0,0,1,0,1,1,3,9,6,2,0,0,0,17
Medio_bajo,No_siniestro,203990,49,1734.81,0,0,7,6,5,4,3,25,3,3,3,3,3,2,17
Medio_bajo,Si_siniestro,246597,6,7375.54,0,3,2,1,1,0,0,7,8,6,2,1,0,0,17
Medio_bajo,Si_siniestro,304986,48,878.45,0,3,2,2,1,1,2,11,4,4,3,2,2,2,17
Medio_bajo,No_siniestro,720753,20,1.37,0,0,0,0,0,0,0,0,3,3,3,3,3,2,17
Medio_bajo,Si_siniestro,768243,65,48.76,0,3,2,1,0,0,0,6,4,4,4,3,1,1,17
Medio_bajo,No_siniestro,646547,64,686.13,0,4,3,3,2,1,1,14,7,4,2,2,1,1,17
Medio_alto,No_siniestro,164618,38,11931.19,83592.63,0,0,0,0,0,0,0,1,1,2,5,4,4,17
Medio_alto,No_siniestro,536078,65,2940.23,0,0,0,0,1,1,1,3,0,1,8,7,1,0,17
Bajo,Si_siniestro,56990,39,0.01,0,0,7,7,7,7,7,35,3,3,2,3,3,3,17
Bajo,Si_siniestro,172632,23,2212.48,0,1,0,0,0,0,0,1,3,2,2,4,4,2,17
Bajo,Si_siniestro,367078,27,1939.94,0,3,2,2,1,0,0,8,6,4,3,2,1,1,17
Bajo,Si_siniestro,626301,16,2689.85,0,3,3,2,2,1,1,12,4,6,2,2,1,2,17
Bajo,Si_siniestro,757989,9,551.01,0,0,2,2,1,0,0,5,3,3,3,2,3,3,17
Bajo,No_siniestro,761153,90,1358.34,0,2,2,1,1,0,0,6,6,5,5,1,0,0,17
Bajo,No_siniestro,513344,7,2322.23,0,5,4,3,2,1,0,15,3,3,3,3,3,2,17
Bajo,No_siniestro,646066,0,861.36,0,0,0,0,0,0,0,0,1,0,4,4,4,4,17
Medio_bajo,Si_siniestro,36786,21,552.72,0,3,7,7,6,5,4,32,7,3,2,2,2,0,16
Medio_bajo,Si_siniestro,181844,18,598.94,0,0,0,2,1,2,0,5,3,5,3,2,2,1,16
Medio_bajo,Si_siniestro,657699,17,504.84,0,2,2,1,1,0,1,7,3,3,2,3,3,2,16
Medio_bajo,No_siniestro,673371,13,858.99,0,0,0,0,0,0,0,0,6,6,4,0,0,0,16
Medio_bajo,No_siniestro,25897,165,3862.35,0,6,5,4,3,2,1,21,5,3,3,4,1,0,16
Medio_bajo,No_siniestro,209467,90,0.01,0,0,0,0,0,0,0,0,3,2,2,1,1,7,16
Medio_bajo,No_siniestro,381341,60,0,0,0,0,0,0,0,0,0,8,8,0,0,0,0,16
Medio_bajo,No_siniestro,461160,42,0,0,0,0,0,0,0,0,0,4,3,3,3,2,1,16
Medio,Si_siniestro,371542,28,4282.5,0,3,3,2,1,3,2,14,6,4,1,1,2,2,16
Bajo,Si_siniestro,57876,7,862.04,0,2,1,2,2,1,0,8,5,4,3,2,2,0,16
Bajo,Si_siniestro,112814,10,1022.11,0,3,5,6,5,2,1,22,4,5,3,2,1,1,16
Bajo,Si_siniestro,213138,28,3078.45,0,2,1,2,1,1,0,7,4,4,5,2,0,1,16
Bajo,Si_siniestro,221080,49,3069.41,0,3,2,1,2,1,1,10,8,3,1,1,1,2,16
Bajo,Si_siniestro,444349,9,3120.93,0,3,2,1,1,1,0,8,5,5,2,3,1,0,16
Bajo,No_siniestro,407884,38,2641.07,0,2,2,2,2,1,1,10,4,4,2,2,2,2,16
Bajo,No_siniestro,768004,22,1926.88,0,1,2,2,1,2,1,9,3,4,4,4,1,0,16
Medio_bajo,No_siniestro,106900,39,3099.01,0,0,0,0,0,0,0,0,3,3,3,2,2,2,15
Medio_bajo,Si_siniestro,153520,39,3934.24,0,0,2,1,2,1,1,7,4,5,1,1,2,2,15
Medio_bajo,Si_siniestro,565859,14,1881.72,0,2,4,3,2,1,1,13,6,4,3,1,0,1,15
Medio_bajo,No_siniestro,722042,60,319.29,0,0,0,0,0,0,0,0,0,0,0,5,5,5,15
Bajo,Si_siniestro,33595,21,1641.77,0,2,1,0,0,0,0,3,4,2,3,2,2,2,15
Bajo,Si_siniestro,114871,60,5106.96,0,2,2,1,1,1,1,8,5,4,2,2,1,1,15
Bajo,Si_siniestro,120877,14,1259.31,0,3,2,3,2,2,1,13,6,3,3,2,1,0,15
Bajo,No_siniestro,124660,39,406.06,0,0,0,0,0,0,0,0,3,3,3,2,2,2,15
Bajo,No_siniestro,228755,55,87.07,0,0,0,0,0,0,0,0,2,3,3,3,2,2,15
Bajo,No_siniestro,310772,17,425.09,0,0,0,0,0,0,0,0,4,5,3,2,1,0,15
Bajo,Si_siniestro,433338,99,349.07,0,1,0,1,0,2,1,5,2,4,3,1,3,2,15
Bajo,Si_siniestro,639070,43,650.17,0,3,2,2,1,0,0,8,5,4,2,2,2,0,15
Bajo,No_siniestro,2392,57,282.56,0,1,1,0,0,1,2,5,3,3,3,2,3,1,15
Bajo,No_siniestro,88545,0,2199.73,0,0,0,0,0,0,0,0,0,0,0,0,8,7,15
Bajo,No_siniestro,441644,32,2257.51,0,0,0,1,1,0,0,2,3,4,4,1,2,1,15
Medio_bajo,Si_siniestro,17581,105,1840.91,0,2,2,2,0,1,2,9,2,1,0,4,4,3,14
Medio_bajo,No_siniestro,400514,122,11961.88,0,0,0,0,0,0,0,0,2,3,2,3,2,2,14
Medio_bajo,Si_siniestro,412843,43,513.1,0,0,1,1,1,0,0,3,2,2,3,3,2,2,14
Medio_bajo,No_siniestro,477705,19,850,0,1,0,1,1,0,0,3,2,2,3,3,2,2,14
Medio_bajo,No_siniestro,231413,12,1158.64,0,2,2,3,2,2,2,13,3,4,3,2,1,1,14
Medio_bajo,No_siniestro,717591,0,0.01,195565.15,0,0,0,0,0,0,0,0,0,6,4,2,2,14
Bajo,No_siniestro,43461,21,289.46,0,0,0,0,0,0,0,0,3,3,2,2,2,2,14
Bajo,No_siniestro,50748,12,220.07,0,2,1,2,1,1,2,9,3,2,2,3,3,1,14
Bajo,Si_siniestro,137469,26,218,0,3,3,2,2,2,1,13,4,4,2,1,2,1,14
Bajo,No_siniestro,229019,70,440.84,0,0,0,0,0,0,0,0,1,2,2,3,3,3,14
Bajo,No_siniestro,559691,11,460.29,0,0,0,0,0,0,0,0,5,4,2,2,1,0,14
Bajo,No_siniestro,573136,6,2993.98,0,2,4,3,2,1,0,12,4,5,4,1,0,0,14
Bajo,Si_siniestro,611574,20,912.57,0,2,2,2,2,2,1,11,3,3,3,3,2,0,14
Bajo,No_siniestro,787673,10,945.85,0,0,0,0,0,0,0,0,5,4,4,1,0,0,14
Bajo,No_siniestro,370279,14,347.92,0,0,0,0,0,0,0,0,3,3,2,2,2,2,14
Bajo,No_siniestro,484510,42,3046.29,0,3,3,3,2,1,0,12,4,3,4,1,1,1,14
Moderado,Si_siniestro,738508,41,31097.56,0,1,0,0,0,0,0,1,3,3,3,3,1,0,13
Medio_bajo,Si_siniestro,177145,30,921.79,0,1,1,0,1,0,0,3,3,3,2,1,2,2,13
Medio_bajo,No_siniestro,424328,50,582.58,0,0,0,0,1,0,1,2,2,2,2,3,2,2,13
Medio_bajo,No_siniestro,511834,22,9674.21,0,0,0,0,0,0,0,0,2,2,2,2,2,3,13
Medio_bajo,No_siniestro,765058,68,1046.13,0,0,1,2,1,0,1,5,4,3,3,1,1,1,13
Medio_bajo,No_siniestro,570152,34,473.98,0,0,0,0,2,1,1,4,2,2,2,2,2,3,13
Medio_bajo,No_siniestro,686979,51,5185.7,0,0,0,0,0,0,0,0,2,2,3,2,2,2,13
Medio_bajo,No_siniestro,697509,32,1475.75,0,4,3,2,1,0,0,10,2,2,3,2,2,2,13
Bajo,Si_siniestro,157406,29,1832.69,0,3,2,2,1,2,0,10,6,3,3,1,0,0,13
Bajo,No_siniestro,305382,7,1794.17,0,0,0,0,0,0,0,0,2,3,3,3,1,1,13
Bajo,Si_siniestro,415275,17,114.18,0,3,2,1,1,1,1,9,4,3,1,2,1,2,13
Bajo,Si_siniestro,557703,13,1690.09,0,1,1,1,1,1,1,6,5,3,1,2,1,1,13
Bajo,Si_siniestro,646380,43,1964.94,0,2,1,1,0,0,0,4,6,3,1,1,1,1,13
Bajo,Si_siniestro,763139,39,115.04,0,0,0,0,0,0,0,0,2,2,2,3,2,2,13
Bajo,No_siniestro,30180,43,1026.34,0,4,3,4,1,1,0,13,5,4,2,1,1,0,13
Bajo,No_siniestro,316007,13,830.64,0,1,0,0,0,0,0,1,3,2,2,2,2,2,13
Bajo,No_siniestro,647185,54,2984.57,0,2,1,1,0,0,0,4,8,3,0,0,0,2,13
Medio_bajo,Si_siniestro,264554,7,6115.82,0,1,1,1,1,0,0,4,2,10,0,0,0,0,12
Medio_bajo,Si_siniestro,264991,128,723.42,0,1,1,0,1,1,1,5,3,1,1,4,2,1,12
Medio_bajo,No_siniestro,363853,25,1850.27,0,0,0,0,0,0,0,0,1,1,3,3,3,1,12
Medio_bajo,Si_siniestro,372174,20,726.15,0,0,1,1,0,0,1,3,3,3,2,1,2,1,12
Medio_bajo,No_siniestro,419425,8,2667.04,0,0,0,2,3,2,1,8,3,4,1,1,3,0,12
Medio_bajo,No_siniestro,640069,12,1045.3,0,0,0,0,0,0,0,0,3,2,2,2,3,0,12
Medio_bajo,Si_siniestro,667086,104,1608.33,0,3,2,2,2,1,1,11,4,4,2,1,1,0,12
Medio_bajo,Si_siniestro,750225,13,4073.19,0,1,1,1,0,1,0,4,2,2,2,2,2,2,12
Medio_bajo,Si_siniestro,757922,11,2090.97,0,3,2,1,0,1,1,8,4,3,3,2,0,0,12
Medio_bajo,No_siniestro,281140,42,59.8,0,0,0,0,0,0,0,0,2,2,2,2,2,2,12
Medio_bajo,No_siniestro,571818,36,322.8,0,0,0,0,0,0,0,0,2,2,2,2,2,2,12
Medio_bajo,No_siniestro,630061,31,1413.68,0,0,0,0,0,0,0,0,12,0,0,0,0,0,12
Medio_bajo,No_siniestro,635501,93,0,0,0,0,0,0,0,4,4,2,2,2,2,2,2,12
Medio_alto,No_siniestro,288116,131,1719.72,0,0,0,0,0,0,0,0,2,2,2,2,2,2,12
Medio_alto,No_siniestro,412431,93,668.64,0,0,0,0,0,0,0,0,2,2,2,2,2,2,12
Medio_alto,No_siniestro,699125,19,4052.63,0,0,0,0,0,0,0,0,2,2,2,2,2,2,12
Medio,No_siniestro,570107,8,8608.53,0,0,0,0,0,0,0,0,0,0,3,3,3,3,12
Medio,No_siniestro,116654,47,0,0,0,0,0,0,0,0,0,2,2,2,2,2,2,12
Bajo,No_siniestro,6484,84,1677.55,0,0,0,0,1,0,1,2,2,2,2,2,2,2,12
Bajo,No_siniestro,72658,9,211.74,0,0,0,0,0,0,0,0,2,2,2,2,2,2,12
Bajo,Si_siniestro,74218,59,1314.5,0,2,2,2,2,2,2,12,2,2,2,2,2,2,12
Bajo,No_siniestro,97751,26,559.68,0,0,0,0,0,0,1,1,2,2,2,2,2,2,12
Bajo,No_siniestro,151129,17,662.94,0,0,0,0,0,0,0,0,5,4,2,1,0,0,12
Bajo,No_siniestro,185624,16,625.48,0,0,0,0,0,0,0,0,2,2,2,2,2,2,12
Bajo,Si_siniestro,277436,11,327.87,0,1,1,0,1,1,2,6,3,2,1,2,2,2,12
Bajo,No_siniestro,398023,62,272.6,0,0,0,0,0,0,0,0,2,2,2,2,2,2,12
Bajo,Si_siniestro,497049,27,4141.07,0,3,2,1,0,1,1,8,6,4,2,0,0,0,12
Bajo,Si_siniestro,511939,9,892.6,0,1,2,2,1,0,1,7,4,3,2,1,1,1,12
Bajo,Si_siniestro,517037,10,358.48,0,2,2,2,2,1,1,10,2,3,3,2,1,1,12
Bajo,Si_siniestro,572963,34,780.32,0,0,3,2,1,2,1,9,2,3,2,1,2,2,12
Bajo,No_siniestro,583061,127,59.45,0,0,0,0,0,0,0,0,0,1,1,3,3,4,12
Bajo,No_siniestro,620185,34,192.96,0,0,0,0,0,0,0,0,2,2,2,2,2,2,12
Bajo,No_siniestro,654348,47,1211.48,0,0,0,0,0,0,0,0,2,2,2,2,2,2,12
Bajo,No_siniestro,779003,26,1071.89,0,1,0,2,1,1,1,6,3,2,2,2,2,1,12
Bajo,No_siniestro,109515,10,893.36,0,2,1,2,1,3,2,11,3,2,2,1,2,2,12
Bajo,No_siniestro,380714,6,727.7,0,5,4,3,2,1,0,15,4,3,2,2,1,0,12
Bajo,No_siniestro,480706,97,139.19,0,5,4,3,2,1,0,15,2,2,2,2,2,2,12
Bajo,No_siniestro,768749,94,0,0,0,0,0,0,0,0,0,4,3,3,2,0,0,12
Medio_bajo,No_siniestro,7988,118,2494,0,0,0,0,0,1,1,2,0,0,0,0,6,5,11
Medio_bajo,Si_siniestro,39076,49,4197.23,0,0,0,0,0,1,1,2,2,2,2,2,2,1,11
Medio_bajo,Si_siniestro,260999,23,881.84,0,1,2,1,1,1,1,7,1,3,2,2,2,1,11
Medio_bajo,Si_siniestro,288085,37,3586.14,0,3,2,2,1,0,2,10,3,2,2,1,1,2,11
Medio_bajo,Si_siniestro,315829,10,5295.23,0,3,2,1,0,0,1,7,7,3,1,0,0,0,11
Medio_bajo,No_siniestro,769022,70,876.73,0,0,1,1,1,1,1,5,4,3,3,1,0,0,11
Medio_bajo,No_siniestro,7646,35,700.43,0,0,0,0,0,0,1,1,1,2,3,2,2,1,11
Medio_bajo,No_siniestro,75434,14,1009.03,0,2,2,3,3,2,2,14,2,2,2,2,1,2,11
Medio_bajo,No_siniestro,276427,1,9556.27,0,0,0,0,0,0,0,0,0,0,0,0,7,4,11
Medio_bajo,No_siniestro,552428,125,5439.27,0,1,0,0,2,1,0,4,2,4,4,1,0,0,11
Bajo,Si_siniestro,23122,19,3387.17,0,2,1,0,0,1,0,4,4,1,1,1,2,2,11
Bajo,Si_siniestro,52495,12,1281.94,0,3,2,2,2,1,1,11,2,2,2,3,1,1,11
Bajo,Si_siniestro,79176,16,522.02,0,3,3,3,2,2,1,14,4,3,2,1,1,0,11
Bajo,Si_siniestro,194268,19,484.59,0,2,2,1,0,0,1,6,4,3,2,1,0,1,11
Bajo,Si_siniestro,212523,52,5789.99,0,0,0,0,0,0,0,0,4,4,2,1,0,0,11
Bajo,No_siniestro,228066,16,576.6,0,1,1,1,1,1,1,6,2,2,2,2,1,2,11
Bajo,No_siniestro,277186,22,1544,0,0,1,0,0,1,1,3,0,0,0,4,5,2,11
Bajo,Si_siniestro,280076,61,3099.86,0,1,0,0,1,1,0,3,2,2,2,2,2,1,11
Bajo,Si_siniestro,372024,11,2054.87,0,2,1,1,0,0,0,4,4,1,3,1,1,1,11
Bajo,No_siniestro,432602,30,3.38,0,0,0,1,2,1,2,6,0,0,4,3,2,2,11
Bajo,Si_siniestro,562367,10,4046.28,0,1,1,1,1,1,0,5,5,3,1,1,0,1,11
Bajo,Si_siniestro,627359,25,898.02,0,3,2,1,0,1,0,7,7,1,1,1,0,1,11
Bajo,No_siniestro,756122,9,953.06,0,0,0,0,0,0,0,0,5,3,3,0,0,0,11
Bajo,No_siniestro,154241,8,264.31,0,0,0,2,1,2,1,6,2,1,5,2,1,0,11
Bajo,No_siniestro,295255,15,1239.9,0,0,0,0,0,0,0,0,3,3,1,1,1,2,11
Bajo,No_siniestro,465339,80,267.37,0,0,0,0,2,1,0,3,2,2,2,2,2,1,11
Bajo,No_siniestro,488225,35,165.56,0,1,0,1,2,2,2,8,2,2,3,2,1,1,11
Medio_bajo,Si_siniestro,44293,7,820.17,0,1,0,1,1,0,0,3,2,2,3,2,1,0,10
Medio_bajo,Si_siniestro,49642,7,2425.85,0,2,1,0,0,2,1,6,3,2,1,1,2,1,10
Medio_bajo,No_siniestro,76992,53,359.66,0,0,0,0,0,0,0,0,4,3,1,0,1,1,10
Medio_bajo,Si_siniestro,104292,22,2036.4,0,0,2,1,0,1,1,5,3,3,1,0,1,2,10
Medio_bajo,No_siniestro,156162,37,2767.85,0,0,0,0,0,1,0,1,1,1,1,2,3,2,10
Medio_bajo,No_siniestro,261601,7,1586.06,0,1,1,1,1,1,1,6,0,3,2,2,2,1,10
Medio_bajo,No_siniestro,398774,56,11606.69,0,0,0,0,0,0,0,0,5,5,0,0,0,0,10
Medio_bajo,Si_siniestro,683613,18,528.48,0,1,1,1,1,0,0,4,3,3,1,1,1,1,10
Medio_bajo,Si_siniestro,723072,54,2062.96,0,0,2,1,1,1,1,6,5,2,2,1,0,0,10
Medio_bajo,No_siniestro,143122,14,10334.6,0,2,3,2,2,1,2,12,3,3,1,2,0,1,10
Medio_bajo,No_siniestro,476042,0,1167.63,0,0,0,0,0,0,0,0,1,3,3,2,1,0,10
Bajo,No_siniestro,9052,7,743.21,0,1,1,0,0,0,0,2,2,2,2,2,2,0,10
Bajo,Si_siniestro,189651,26,540.99,0,3,2,2,1,1,1,10,3,2,2,1,1,1,10
Bajo,Si_siniestro,193563,25,1165.53,0,2,2,2,1,0,0,7,3,2,2,2,1,0,10
Bajo,Si_siniestro,201609,56,2409.08,0,3,2,1,1,1,0,8,4,2,2,2,0,0,10
Bajo,Si_siniestro,217459,11,1188.46,0,2,2,1,1,0,0,6,2,3,3,2,0,0,10
Bajo,Si_siniestro,249676,8,1146.41,0,2,2,1,1,0,0,6,5,3,1,1,0,0,10
Bajo,Si_siniestro,311419,6,993.34,0,2,1,1,1,0,0,5,2,2,2,2,1,1,10
Bajo,No_siniestro,404982,6,520.32,0,0,4,3,2,1,0,10,4,3,2,1,0,0,10
Bajo,Si_siniestro,446039,15,2383,0,3,2,2,1,1,0,9,3,3,3,1,0,0,10
Bajo,No_siniestro,497055,88,1060.94,0,1,2,2,1,1,1,8,3,2,1,1,2,1,10
Bajo,No_siniestro,550802,67,1828.94,0,1,1,0,1,0,0,3,2,1,1,0,1,5,10
Bajo,Si_siniestro,603430,40,425.22,0,1,0,0,2,2,1,6,2,0,3,3,1,1,10
Bajo,Si_siniestro,630441,23,407.79,0,1,1,0,1,0,2,5,3,2,1,1,1,2,10
Bajo,Si_siniestro,648891,11,763.13,0,1,0,1,1,1,0,4,6,1,1,1,1,0,10
Bajo,No_siniestro,665081,6,1029.98,0,0,0,0,0,0,0,0,3,3,2,1,1,0,10
Bajo,No_siniestro,313353,10,886.07,0,5,4,3,2,1,0,15,2,2,3,2,1,0,10
Bajo,No_siniestro,374980,42,938.2,0,0,0,0,0,0,0,0,2,0,0,0,0,8,10
Medio_bajo,Si_siniestro,11356,49,3071.23,0,1,1,1,0,0,0,3,2,2,2,2,1,0,9
Medio_bajo,Si_siniestro,92973,12,940.81,0,2,1,2,1,0,0,6,3,1,2,1,1,1,9
Medio_bajo,No_siniestro,160557,66,10723.82,0,0,0,1,0,1,0,2,3,2,2,0,0,2,9
Medio_bajo,No_siniestro,170675,18,64.94,0,0,2,1,0,0,2,5,2,1,2,2,2,0,9
Medio_bajo,Si_siniestro,346194,107,4468.03,0,0,2,1,1,1,1,6,5,2,1,1,0,0,9
Medio_bajo,No_siniestro,390095,24,593.71,0,0,0,1,0,2,1,4,1,1,2,1,3,1,9
Medio_bajo,Si_siniestro,555560,40,2910.75,0,1,0,0,0,0,0,1,2,2,2,2,1,0,9
Medio_bajo,No_siniestro,587266,32,7503.36,0,0,7,7,7,7,7,35,1,3,2,1,1,1,9
Medio_bajo,No_siniestro,606967,89,768.56,0,0,0,0,0,0,0,0,1,2,2,2,1,1,9
Medio_bajo,No_siniestro,674804,9,6155.05,0,1,0,0,0,0,0,1,4,4,1,0,0,0,9
Medio_bajo,No_siniestro,682374,11,4177.88,0,0,0,0,1,1,1,3,0,0,1,3,3,2,9
Medio_bajo,No_siniestro,692423,7,381.56,0,0,0,0,0,0,0,0,2,2,1,2,1,1,9
Medio_bajo,No_siniestro,693401,21,988.28,0,0,0,1,0,0,0,1,2,2,2,1,1,1,9
Medio_bajo,No_siniestro,699812,61,6959.16,0,3,3,2,0,0,0,8,1,1,1,2,2,2,9
Medio_bajo,Si_siniestro,761284,6,939.19,0,2,7,7,7,7,7,37,2,2,2,1,1,1,9
Medio_bajo,No_siniestro,771805,86,550.99,0,0,0,0,0,0,2,2,1,1,1,2,2,2,9
Medio_bajo,No_siniestro,425583,98,3636.77,0,1,0,1,0,1,0,3,0,1,2,2,2,2,9
Medio_bajo,No_siniestro,493241,1,992.74,0,0,0,0,0,0,0,0,4,2,2,1,0,0,9
Medio_bajo,No_siniestro,610220,42,1508.06,0,4,4,3,0,0,0,11,4,0,5,0,0,0,9
Medio_bajo,No_siniestro,644660,42,20331.3,0,0,0,0,0,0,0,0,3,3,0,1,1,1,9
Medio_alto,No_siniestro,339881,13,6590.95,67160.53,0,0,3,2,1,0,6,0,2,5,2,0,0,9
Medio,No_siniestro,644366,7,835.45,0,1,0,0,0,0,0,1,3,2,0,0,1,3,9
Bajo,Si_siniestro,211992,6,1876.81,0,3,2,1,0,0,0,6,5,3,1,0,0,0,9
Bajo,No_siniestro,278478,184,1526.24,0,0,0,0,0,0,0,0,1,1,1,2,3,1,9
Bajo,Si_siniestro,303466,9,2449.54,0,1,0,0,0,0,0,1,2,1,3,1,1,1,9
Bajo,No_siniestro,312317,13,4188.91,0,0,2,1,1,1,0,5,0,2,2,2,2,1,9
Bajo,No_siniestro,407525,89,584.21,0,0,0,0,0,0,0,0,2,2,2,1,1,1,9
Bajo,Si_siniestro,432444,11,263.33,0,1,0,1,1,2,1,6,1,2,1,2,2,1,9
Bajo,Si_siniestro,444101,13,625,0,3,2,1,1,1,1,9,3,2,1,1,1,1,9
Bajo,Si_siniestro,469697,81,641.6,0,2,1,0,1,0,2,6,1,1,1,1,3,2,9
Bajo,No_siniestro,530084,7,1386.26,0,1,0,0,0,0,0,1,1,2,2,1,2,1,9
Bajo,No_siniestro,617071,26,963.54,0,0,0,0,0,0,0,0,1,1,2,2,2,1,9
Bajo,Si_siniestro,627958,6,1456.07,0,1,1,0,0,0,0,2,3,2,1,1,1,1,9
Bajo,Si_siniestro,638737,6,2842.58,0,1,0,0,0,0,0,1,5,1,1,1,1,0,9
Bajo,No_siniestro,105721,20,256.08,0,1,1,1,1,1,2,7,2,1,1,1,2,2,9
Bajo,No_siniestro,240380,42,0,0,0,1,0,0,1,3,5,1,2,1,1,1,3,9
Bajo,No_siniestro,758112,31,1315.95,0,1,0,0,0,0,0,1,2,1,1,1,2,2,9
Medio_bajo,Si_siniestro,42013,21,6400.63,42310.41,0,1,0,1,1,1,4,1,0,0,2,1,4,8
Medio_bajo,No_siniestro,45343,39,3179.53,10876.27,0,7,7,6,5,4,29,1,1,1,2,2,1,8
Medio_bajo,No_siniestro,58566,18,5141.85,0,0,0,0,0,1,1,2,2,4,0,1,1,0,8
Medio_bajo,No_siniestro,110056,31,1019.65,0,0,0,0,0,0,0,0,1,1,2,2,1,1,8
Medio_bajo,No_siniestro,216711,6,1556.44,0,0,0,0,0,0,0,0,0,0,2,2,2,2,8
Medio_bajo,No_siniestro,232114,22,1501.01,0,0,0,0,0,0,0,0,2,2,2,1,1,0,8
Medio_bajo,No_siniestro,258786,58,2278.64,0,1,0,1,0,0,0,2,4,3,1,0,0,0,8
Medio_bajo,No_siniestro,405092,105,17975.35,64358.7,0,1,1,0,1,1,4,1,1,1,0,0,5,8
Medio_bajo,No_siniestro,474753,21,1972.8,0,0,0,0,0,0,0,0,2,2,2,2,0,0,8
Medio_bajo,Si_siniestro,485822,16,9816.51,0,3,2,1,0,1,0,7,3,3,2,0,0,0,8
Medio_bajo,Si_siniestro,559408,109,1173.54,0,2,1,0,0,0,0,3,3,1,1,1,1,1,8
Medio_bajo,Si_siniestro,593861,57,1780.59,0,0,0,2,1,0,0,3,1,2,2,1,1,1,8
Medio_bajo,No_siniestro,676283,46,175.62,0,0,0,0,0,0,0,0,3,3,1,1,0,0,8
Medio_bajo,Si_siniestro,677148,13,678.36,0,1,0,0,0,0,0,1,3,3,0,1,1,0,8
Medio_bajo,No_siniestro,684032,32,9016.68,0,0,0,0,0,0,0,0,2,2,1,1,1,1,8
Medio_bajo,No_siniestro,724781,140,4976.13,0,0,0,0,0,0,0,0,4,2,2,0,0,0,8
Medio_bajo,No_siniestro,742811,10,845.64,0,0,0,0,0,0,0,0,0,0,0,3,3,2,8
Medio_bajo,Si_siniestro,766002,34,6698.05,0,3,2,1,0,0,0,6,3,2,2,1,0,0,8
Medio_bajo,No_siniestro,446562,39,12938.5,0,0,0,0,0,0,0,0,0,0,0,0,0,8,8
Medio_bajo,No_siniestro,595973,33,770.46,0,2,1,2,1,0,0,6,2,4,2,0,0,0,8
Medio_alto,No_siniestro,135158,156,40162.46,0,1,1,1,1,1,3,8,1,1,1,2,1,2,8
Medio,Si_siniestro,447391,8,1466.58,0,0,0,0,0,0,0,0,1,1,0,2,2,2,8
Medio,No_siniestro,641837,39,832.96,0,0,3,2,0,0,0,5,0,0,2,2,2,2,8
Medio,No_siniestro,444976,11,416.48,0,0,0,0,0,0,0,0,3,3,1,1,0,0,8
Bajo,No_siniestro,18221,6,1503.86,0,0,0,0,0,0,0,0,0,2,2,2,1,1,8
Bajo,Si_siniestro,41387,6,177.03,0,2,1,2,2,1,0,8,2,1,2,2,1,0,8
Bajo,Si_siniestro,49148,6,1507.65,0,3,2,3,0,0,0,8,5,2,1,0,0,0,8
Bajo,Si_siniestro,92824,82,227.13,0,1,0,1,0,0,0,2,3,1,1,0,1,2,8
Bajo,Si_siniestro,109032,15,1739.42,0,2,1,0,0,0,0,3,3,2,1,1,1,0,8
Bajo,Si_siniestro,156689,13,2398.84,0,3,3,2,2,1,1,12,3,2,2,1,0,0,8
Bajo,No_siniestro,169008,60,293.18,0,0,0,0,0,0,0,0,0,0,3,3,1,1,8
Bajo,No_siniestro,209710,49,1561.26,0,0,1,1,0,0,0,2,2,2,1,1,1,1,8
Bajo,Si_siniestro,312489,10,1390.56,0,2,2,1,0,0,1,6,4,3,1,0,0,0,8
Bajo,No_siniestro,433978,13,502.25,0,1,1,1,1,0,0,4,3,2,3,0,0,0,8
Bajo,Si_siniestro,446709,6,1274.38,0,1,1,0,0,0,0,2,3,1,1,1,1,1,8
Bajo,Si_siniestro,497893,23,478.44,0,2,1,1,1,1,0,6,1,1,2,2,1,1,8
Bajo,No_siniestro,568540,40,829.36,0,0,0,1,0,1,1,3,2,1,1,1,1,2,8
Bajo,No_siniestro,641420,43,4219.61,0,0,0,0,0,0,0,0,5,1,0,0,2,0,8
Bajo,No_siniestro,674593,9,736.42,0,0,0,0,0,0,0,0,2,2,1,1,1,1,8
Bajo,No_siniestro,733430,43,628.8,0,0,0,0,0,0,0,0,3,2,2,1,0,0,8
Bajo,No_siniestro,51897,69,1424.34,0,2,1,2,1,1,1,8,2,1,2,1,1,1,8
Bajo,No_siniestro,60231,13,987.97,0,0,0,0,1,0,0,1,1,1,2,2,1,1,8
Bajo,No_siniestro,215264,7,3062.65,0,2,2,1,0,0,0,5,2,2,2,1,1,0,8
Bajo,No_siniestro,547014,14,252.73,0,1,0,1,3,3,2,10,2,2,1,3,0,0,8
Bajo,No_siniestro,763542,0,399.85,0,0,0,0,0,0,0,0,1,1,1,1,2,2,8
Moderado,Si_siniestro,75424,151,723.74,0,0,0,2,1,0,1,4,1,1,1,1,2,1,7
Medio_bajo,No_siniestro,12911,26,9369.31,0,0,0,0,0,1,1,2,2,0,0,0,2,3,7
Medio_bajo,No_siniestro,16362,115,2204.6,0,0,0,1,1,2,2,6,1,0,1,1,2,2,7
Medio_bajo,Si_siniestro,154819,75,9576.38,0,0,1,0,0,0,0,1,1,1,1,1,1,2,7
Medio_bajo,Si_siniestro,211232,17,2498.36,0,2,1,1,1,1,1,7,1,2,0,1,1,2,7
Medio_bajo,No_siniestro,236481,40,8562.24,0,0,0,1,0,1,0,2,0,1,0,2,0,4,7
Medio_bajo,No_siniestro,257579,120,1550.69,0,1,0,1,2,1,0,5,1,1,2,2,1,0,7
Medio_bajo,No_siniestro,314785,84,10933.44,0,0,0,0,0,0,5,5,1,1,1,1,1,2,7
Medio_bajo,No_siniestro,336662,32,14.24,9123.73,0,0,1,0,1,1,3,1,1,1,1,1,2,7
Medio_bajo,Si_siniestro,345732,10,1706.85,0,0,0,0,0,0,0,0,2,1,1,0,0,3,7
Medio_bajo,No_siniestro,357123,36,434.63,0,0,0,0,0,0,0,0,2,1,1,1,1,1,7
Medio_bajo,No_siniestro,416107,21,9015.93,0,0,0,0,0,0,0,0,0,0,1,2,2,2,7
Medio_bajo,No_siniestro,484304,26,103.06,0,0,0,0,0,0,0,0,1,1,1,2,1,1,7
Medio_bajo,No_siniestro,521930,40,638.39,0,0,0,0,0,5,4,9,1,1,1,1,1,2,7
Medio_bajo,No_siniestro,531784,131,618.22,0,1,1,2,1,2,1,8,1,1,1,1,2,1,7
Medio_bajo,Si_siniestro,535556,15,246.39,0,1,1,1,1,3,2,9,1,1,1,0,3,1,7
Medio_bajo,Si_siniestro,563347,21,3646.69,0,0,0,0,0,0,0,0,1,2,1,1,1,1,7
Medio_bajo,Si_siniestro,653362,58,14170.99,0,0,1,0,0,0,0,1,3,3,1,0,0,0,7
Medio_bajo,No_siniestro,653774,73,4693,0,0,1,0,0,0,0,1,2,2,1,1,1,0,7
Medio_bajo,No_siniestro,725676,36,6454.94,0,0,0,0,1,0,0,1,1,1,1,2,1,1,7
Medio_bajo,Si_siniestro,736176,36,1085.73,0,0,0,0,2,1,0,3,2,1,1,3,0,0,7
Medio_bajo,No_siniestro,746274,32,7980.88,0,0,0,0,0,0,0,0,2,1,1,1,1,1,7
Medio_bajo,No_siniestro,7622,32,1243.21,0,1,2,1,1,1,1,7,1,1,1,1,2,1,7
Medio_bajo,No_siniestro,15420,43,0,0,2,1,0,1,0,0,4,0,0,1,2,2,2,7
Medio_bajo,No_siniestro,169271,4,1194.52,0,5,4,3,2,0,0,14,2,2,2,1,0,0,7
Medio_bajo,No_siniestro,265444,4,390.36,0,0,0,0,0,0,0,0,1,1,1,1,2,1,7
Medio_bajo,No_siniestro,361187,0,3000,0,1,0,0,0,0,0,1,1,1,0,1,1,3,7
Medio_bajo,No_siniestro,520450,42,3634.39,0,1,0,0,0,0,0,1,2,1,1,1,1,1,7
Medio_bajo,No_siniestro,525988,122,0,0,0,7,6,5,4,1,23,2,1,1,1,2,0,7
Medio_bajo,No_siniestro,537409,1,575.8,0,0,0,0,0,0,0,0,1,1,1,0,2,2,7
Medio_bajo,No_siniestro,627445,47,2400.58,0,0,0,0,0,0,0,0,2,1,1,1,1,1,7
Medio,No_siniestro,640527,8,9414.68,0,1,0,0,0,0,0,1,1,0,2,2,2,0,7
Bajo,No_siniestro,228636,6,2547.26,0,1,1,1,0,0,0,3,1,1,1,2,1,1,7
Bajo,No_siniestro,316089,10,422.92,0,0,0,0,0,0,0,0,3,3,0,0,1,0,7
Bajo,No_siniestro,334319,115,44.13,0,0,0,1,0,0,2,3,1,1,1,1,1,2,7
Bajo,Si_siniestro,364043,15,845.04,0,0,0,0,0,0,0,0,3,2,0,1,1,0,7
Bajo,No_siniestro,414642,13,341.54,0,0,0,1,1,1,1,4,0,1,1,1,1,3,7
Bajo,Si_siniestro,460197,22,334.77,0,3,2,1,0,2,1,9,2,1,1,0,2,1,7
Bajo,Si_siniestro,495864,13,982.4,0,0,0,0,0,0,0,0,2,2,1,1,1,0,7
Bajo,Si_siniestro,504864,10,1003.22,0,3,2,1,1,1,0,8,2,1,1,1,1,1,7
Bajo,Si_siniestro,513382,11,249.94,0,2,1,1,1,2,1,8,1,1,1,1,2,1,7
Bajo,Si_siniestro,539364,18,755.54,0,0,0,0,0,0,0,0,1,1,1,2,1,1,7
Bajo,No_siniestro,587437,112,0.03,0,0,0,1,0,0,0,1,1,1,1,1,1,2,7
Bajo,Si_siniestro,594247,20,2319.25,0,1,0,2,1,0,1,5,4,1,1,0,0,1,7
Bajo,Si_siniestro,629519,30,200.32,0,3,2,1,1,1,0,8,2,1,2,2,0,0,7
Bajo,Si_siniestro,631927,8,1061.96,0,3,3,2,1,0,0,9,4,3,0,0,0,0,7
Bajo,Si_siniestro,643263,8,3139.85,0,2,1,0,0,0,0,3,5,1,0,0,1,0,7
Bajo,Si_siniestro,648706,13,643.02,0,1,1,1,2,2,1,8,1,0,2,2,1,1,7
Bajo,Si_siniestro,654869,62,769.73,0,2,1,1,1,2,2,9,1,1,0,2,2,1,7
Bajo,Si_siniestro,659800,43,355.99,0,2,1,0,1,0,0,4,3,3,1,0,0,0,7
Bajo,Si_siniestro,758059,11,2870.22,0,3,2,1,0,0,0,6,3,2,2,0,0,0,7
Bajo,No_siniestro,380625,3,1659.93,0,2,1,0,0,0,0,3,5,0,0,1,1,0,7
Bajo,No_siniestro,687950,42,1182.68,0,0,0,0,0,0,0,0,3,3,1,0,0,0,7
Moderado,No_siniestro,666241,46,20.22,0,1,0,1,0,0,0,2,0,0,1,1,1,3,6
Moderado,No_siniestro,652151,67,54.3,0,4,3,2,1,0,1,11,1,1,2,1,1,0,6
Medio_bajo,No_siniestro,4584,9,281.02,0,0,0,0,0,1,0,1,1,1,1,1,1,1,6
Medio_bajo,No_siniestro,7744,97,9894.27,0,0,0,0,0,0,0,0,1,1,1,1,1,1,6
Medio_bajo,Si_siniestro,39483,11,1720.6,0,1,1,1,1,0,0,4,1,2,1,1,1,0,6
Medio_bajo,No_siniestro,48448,66,2752.66,0,0,0,0,2,1,0,3,1,1,0,2,1,1,6
Medio_bajo,No_siniestro,50963,20,3777.94,0,0,0,0,0,0,0,0,1,1,1,1,1,1,6
Medio_bajo,No_siniestro,83605,22,3693.55,0,0,0,0,0,0,0,0,1,1,1,1,1,1,6
Medio_bajo,No_siniestro,86073,46,4087.86,0,0,0,0,0,0,0,0,1,1,1,1,1,1,6
Medio_bajo,No_siniestro,100946,15,57.71,0,0,0,0,0,0,0,0,1,1,1,1,1,1,6
Medio_bajo,Si_siniestro,172378,38,12.21,0,0,0,0,0,0,0,0,1,1,1,1,1,1,6
Medio_bajo,Si_siniestro,184790,49,896.23,0,1,1,0,1,1,1,5,1,2,2,1,0,0,6
Medio_bajo,Si_siniestro,193598,7,1036.8,0,2,3,2,2,1,0,10,2,1,0,2,1,0,6
Medio_bajo,No_siniestro,196987,11,93.11,0,0,0,0,0,0,0,0,1,1,1,1,1,1,6
Medio_bajo,No_siniestro,198993,20,2659.33,0,0,0,0,0,0,0,0,1,1,1,1,1,1,6
Medio_bajo,No_siniestro,221394,85,484.85,0,0,0,0,0,0,0,0,1,1,1,1,1,1,6
Medio_bajo,No_siniestro,224864,15,514.25,0,0,1,0,1,1,1,4,1,1,1,1,1,1,6
Medio_bajo,No_siniestro,230910,49,148.72,0,0,0,0,0,0,1,1,1,1,1,1,1,1,6
Medio_bajo,Si_siniestro,268297,60,8203.82,0,0,0,0,6,5,4,15,1,1,1,1,1,1,6
Medio_bajo,Si_siniestro,298814,89,2140.45,0,0,0,0,0,0,1,1,0,0,3,2,1,0,6
Medio_bajo,Si_siniestro,303933,13,3138.74,0,0,0,0,0,0,0,0,2,2,1,1,0,0,6
Medio_bajo,No_siniestro,328490,44,455.64,0,0,0,0,0,0,0,0,0,1,2,1,1,1,6
Medio_bajo,No_siniestro,345671,30,4117.18,0,1,0,0,0,0,0,1,1,1,1,1,1,1,6
Medio_bajo,Si_siniestro,363983,38,4177.74,0,3,3,1,1,1,1,10,2,0,1,0,2,1,6
Medio_bajo,Si_siniestro,433437,13,13110.53,0,2,1,1,1,2,1,8,3,1,0,0,1,1,6
Medio_bajo,Si_siniestro,441338,27,883.87,0,0,2,1,0,1,0,4,2,2,1,0,1,0,6
Medio_bajo,No_siniestro,484935,80,1216.2,0,0,0,0,0,0,0,0,1,1,1,1,1,1,6
Medio_bajo,Si_siniestro,509239,7,680.72,0,0,0,0,0,0,0,0,2,1,1,1,1,0,6
Medio_bajo,Si_siniestro,521555,12,2990.29,0,1,0,1,1,0,1,4,1,1,1,1,1,1,6
Medio_bajo,No_siniestro,529392,72,19295.5,0,0,0,0,0,0,0,0,1,1,1,1,1,1,6
Medio_bajo,No_siniestro,539634,29,2520.21,0,0,0,0,0,0,0,0,1,1,1,1,1,1,6
Medio_bajo,No_siniestro,549770,40,379.28,0,0,0,0,1,0,0,1,1,1,1,1,1,1,6
Medio_bajo,No_siniestro,550717,60,7920.55,0,0,0,0,0,0,0,0,1,1,1,1,1,1,6
Medio_bajo,Si_siniestro,555622,6,977.76,0,0,0,1,1,0,0,2,1,3,2,0,0,0,6
Medio_bajo,No_siniestro,557464,27,7255.16,0,0,0,0,0,0,0,0,1,1,1,1,1,1,6
Medio_bajo,No_siniestro,558502,29,10170.62,0,0,0,0,0,0,0,0,1,1,1,1,1,1,6
Medio_bajo,No_siniestro,587728,47,320.03,0,0,0,0,0,0,0,0,1,1,1,1,1,1,6
Medio_bajo,No_siniestro,598650,40,1492.55,0,0,0,0,0,0,0,0,1,1,1,1,1,1,6
Medio_bajo,No_siniestro,635396,49,944.78,0,0,0,0,0,0,0,0,1,1,1,1,1,1,6
Medio_bajo,Si_siniestro,649570,43,609.37,0,0,0,0,0,0,1,1,1,1,1,1,1,1,6
Medio_bajo,No_siniestro,662901,83,3160.28,0,0,0,0,0,0,0,0,1,1,1,1,1,1,6
Medio_bajo,No_siniestro,677697,28,2141.64,0,0,7,7,7,7,7,35,1,1,1,1,1,1,6
Medio_bajo,No_siniestro,679203,28,337.88,0,0,0,0,0,0,0,0,1,1,1,1,1,1,6
Medio_bajo,No_siniestro,686067,28,3828.55,15953.54,0,0,0,0,0,0,0,3,3,0,0,0,0,6
Medio_bajo,No_siniestro,715505,14,9763.02,0,1,1,0,1,0,0,3,1,1,1,1,1,1,6
Medio_bajo,No_siniestro,731051,6,1213.4,0,0,0,0,0,0,0,0,1,1,1,1,1,1,6
Medio_bajo,No_siniestro,743541,35,0.02,0,0,0,0,0,0,0,0,1,1,1,1,1,1,6
Medio_bajo,Si_siniestro,744866,27,18.4,0,0,0,0,0,0,0,0,1,1,1,1,1,1,6
Medio_bajo,Si_siniestro,750479,109,5798.01,0,0,0,1,1,0,0,2,2,2,2,0,0,0,6
Medio_bajo,No_siniestro,764776,24,262.56,0,0,0,0,0,0,1,1,1,1,1,1,1,1,6
Medio_bajo,Si_siniestro,770169,23,2707.12,0,0,0,0,1,0,0,1,1,1,1,1,1,1,6
Medio_bajo,No_siniestro,93672,167,0,0,0,0,0,0,0,0,0,1,1,1,1,1,1,6
Medio_bajo,No_siniestro,93847,57,0,0,0,7,7,7,7,7,35,1,1,1,1,1,1,6
Medio_bajo,No_siniestro,116935,7,704.7,0,0,1,0,0,0,0,1,1,1,0,2,1,1,6
Medio_bajo,No_siniestro,238953,21,0,0,0,7,7,7,7,6,34,1,1,1,1,1,1,6
Medio_bajo,No_siniestro,403500,42,1863.21,0,1,0,1,1,1,1,5,0,0,0,0,2,4,6
Medio_bajo,No_siniestro,417358,0,0.17,0,0,0,0,0,0,0,0,1,1,1,1,1,1,6
Medio_bajo,No_siniestro,455959,33,0,0,0,0,0,0,0,0,0,1,1,1,1,1,1,6
Medio_bajo,No_siniestro,771412,101,0,0,0,0,0,0,0,0,0,1,1,1,1,1,1,6
Medio_alto,No_siniestro,198202,132,3022.77,11176.1,0,0,0,0,0,0,0,0,0,0,2,2,2,6
Medio_alto,No_siniestro,477346,166,25814.53,25679.51,0,0,0,0,0,0,0,1,1,1,1,1,1,6
Medio_alto,Si_siniestro,485670,40,22100.5,0,0,0,0,0,4,3,7,2,1,1,0,1,1,6
Medio_alto,No_siniestro,548265,29,10762.13,0,0,0,0,0,0,0,0,1,1,1,1,1,1,6
Medio_alto,No_siniestro,581990,40,13319,0,0,0,0,0,0,0,0,1,1,1,1,1,1,6
Medio_alto,No_siniestro,683554,44,7150.04,0,1,0,0,0,0,0,1,3,3,0,0,0,0,6
Medio_alto,No_siniestro,688099,107,2782.88,123803.6,0,0,0,0,0,0,0,1,1,1,1,1,1,6
Medio_alto,No_siniestro,699447,103,4489.66,0,1,0,0,0,0,0,1,3,3,0,0,0,0,6
Medio,No_siniestro,303574,103,4021.92,0,0,0,0,0,0,0,0,1,1,1,1,1,1,6
Bajo,Si_siniestro,8183,127,930.51,0,2,1,2,1,1,0,7,2,3,1,0,0,0,6
Bajo,No_siniestro,11266,11,1292.31,0,0,0,0,0,0,0,0,1,2,2,1,0,0,6
Bajo,No_siniestro,29550,39,367.9,0,0,0,0,0,0,0,0,1,1,1,1,1,1,6
Bajo,No_siniestro,46717,105,1189.5,0,0,1,0,1,1,0,3,1,1,1,1,1,1,6
Bajo,No_siniestro,71962,128,258.82,0,0,0,0,0,0,0,0,1,1,1,1,1,1,6
Bajo,No_siniestro,78926,20,990.16,0,0,0,0,0,0,0,0,1,1,1,1,1,1,6
Bajo,No_siniestro,97731,19,748.94,0,0,0,0,0,0,0,0,1,1,1,1,1,1,6
Bajo,No_siniestro,126338,43,546.28,7894.07,0,0,0,0,0,0,0,1,1,1,1,1,1,6
Bajo,No_siniestro,160129,31,293.82,0,0,0,0,0,0,1,1,1,1,1,1,1,1,6
Bajo,No_siniestro,267788,94,35.03,0,0,0,0,0,0,0,0,1,1,1,1,1,1,6
Bajo,Si_siniestro,315448,6,459.02,0,0,0,0,0,0,0,0,2,1,0,0,2,1,6
Bajo,No_siniestro,329151,77,781.75,0,0,0,0,0,0,0,0,1,1,1,1,1,1,6
Bajo,Si_siniestro,341040,44,66.77,0,3,2,1,0,0,0,6,1,1,1,1,1,1,6
Bajo,No_siniestro,346779,11,592.74,0,0,0,0,0,0,0,0,1,1,1,1,1,1,6
Bajo,No_siniestro,364970,44,768.72,0,0,0,0,0,0,0,0,5,1,0,0,0,0,6
Bajo,No_siniestro,419901,41,317.07,0,0,0,0,0,0,0,0,1,1,1,1,1,1,6
Bajo,No_siniestro,423091,41,189.27,0,0,0,0,0,0,0,0,1,1,1,1,1,1,6
Bajo,No_siniestro,427110,44,774.84,0,0,0,0,0,0,0,0,1,1,1,1,1,1,6
Bajo,No_siniestro,432717,50,18.29,0,0,0,0,0,0,0,0,1,1,1,1,1,1,6
Bajo,No_siniestro,472061,6,1797.65,0,0,0,0,0,0,0,0,1,1,1,1,1,1,6
Bajo,No_siniestro,476560,40,697.58,0,0,0,0,1,0,0,1,1,1,1,1,1,1,6
Bajo,No_siniestro,556958,29,226.71,0,0,0,0,0,0,0,0,1,1,1,1,1,1,6
Bajo,No_siniestro,557083,9,994.47,0,1,1,1,1,1,1,6,2,1,1,1,0,1,6
Bajo,No_siniestro,560660,40,282.76,0,1,0,0,0,1,0,2,1,1,1,1,1,1,6
Bajo,Si_siniestro,566407,8,1023.66,0,3,2,1,0,0,0,6,3,1,1,1,0,0,6
Bajo,No_siniestro,566418,9,690.33,0,0,0,0,0,0,0,0,1,1,1,1,1,1,6
Bajo,No_siniestro,615383,15,2259.87,0,0,0,0,0,0,0,0,1,1,1,1,1,1,6
Bajo,No_siniestro,626128,108,281.88,0,0,0,0,0,0,0,0,1,1,1,1,1,1,6
Bajo,Si_siniestro,652186,113,1584.83,0,0,0,0,0,0,0,0,1,1,1,1,1,1,6
Bajo,No_siniestro,676001,9,672.59,0,0,0,0,0,0,0,0,1,1,1,1,1,1,6
Bajo,No_siniestro,689943,10,1138.25,0,0,0,0,0,0,0,0,2,2,1,1,0,0,6
Bajo,Si_siniestro,705110,43,1542.6,0,0,0,1,1,1,1,4,1,1,1,1,1,1,6
Bajo,Si_siniestro,713058,11,1802.58,0,2,1,0,0,0,0,3,3,3,0,0,0,0,6
Bajo,No_siniestro,8940,43,0,0,0,0,0,0,0,0,0,1,1,1,1,1,1,6
Bajo,No_siniestro,29578,36,0,0,0,7,7,7,7,7,35,1,1,1,1,1,1,6
Bajo,No_siniestro,82148,107,0,0,0,0,0,0,0,0,0,1,1,1,1,1,1,6
Bajo,No_siniestro,179871,84,0,0,0,0,0,0,0,0,0,1,1,1,1,1,1,6
Bajo,No_siniestro,183130,42,2551.54,0,0,0,0,0,0,0,0,0,0,1,2,2,1,6
Bajo,No_siniestro,228959,5,1136.27,0,2,1,1,1,0,0,5,2,1,1,1,0,1,6
Bajo,No_siniestro,347333,21,181.12,0,0,0,0,0,0,0,0,1,1,1,1,1,1,6
Bajo,No_siniestro,477169,8,262.94,0,0,0,0,0,0,0,0,1,1,1,1,1,1,6
Bajo,No_siniestro,605330,42,0,0,0,2,1,0,0,1,4,0,2,1,1,1,1,6
Bajo,No_siniestro,668551,29,17.8,0,4,3,2,1,0,2,12,1,1,1,1,1,1,6
Bajo,No_siniestro,708439,7,1872.6,0,0,0,0,0,0,0,0,2,2,1,1,0,0,6
Bajo,No_siniestro,710729,19,130.33,0,1,2,1,2,1,1,8,1,1,1,1,1,1,6
Bajo,No_siniestro,711350,42,1617.99,0,4,3,2,1,1,0,11,2,2,2,0,0,0,6
Bajo,No_siniestro,713326,0,521.94,0,0,0,0,0,0,0,0,1,1,1,1,1,1,6
Bajo,No_siniestro,718411,5,4157.89,0,2,1,0,0,0,0,3,2,2,2,0,0,0,6
Bajo,No_siniestro,789246,2,2090.8,0,0,0,0,0,0,0,0,2,2,2,0,0,0,6
Moderado,No_siniestro,223997,75,22679.09,179091.76,0,0,0,0,1,3,4,0,0,1,1,1,2,5
Moderado,No_siniestro,7725,64,0.39,156483.31,1,3,2,1,1,1,9,0,2,0,1,1,1,5
Medio_bajo,No_siniestro,23732,66,475,0,0,0,0,0,0,0,0,0,1,1,1,1,1,5
Medio_bajo,Si_siniestro,96755,50,79.19,0,0,0,0,1,1,1,3,0,1,0,2,1,1,5
Medio_bajo,Si_siniestro,194379,46,16173.38,0,0,1,1,1,1,0,4,2,2,1,0,0,0,5
Medio_bajo,No_siniestro,205297,93,1581.42,0,0,0,0,0,0,0,0,0,1,1,1,1,1,5
Medio_bajo,No_siniestro,242385,29,994.87,0,0,0,0,0,1,0,1,2,0,1,0,1,1,5
Medio_bajo,No_siniestro,349350,44,1532.54,0,0,0,0,1,0,0,1,0,1,2,2,0,0,5
Medio_bajo,No_siniestro,364632,101,2956.36,0,0,0,0,0,0,0,0,0,1,1,1,1,1,5
Medio_bajo,No_siniestro,429940,44,1082.64,0,0,0,0,0,0,0,0,1,1,1,1,1,0,5
Medio_bajo,No_siniestro,442381,12,341.69,0,0,1,0,0,0,0,1,2,2,1,0,0,0,5
Medio_bajo,No_siniestro,532515,51,697.73,0,1,0,0,0,0,0,1,1,1,1,1,0,1,5
Medio_bajo,No_siniestro,588847,10,526.71,0,1,2,2,2,2,2,11,0,1,1,1,1,1,5
Medio_bajo,Si_siniestro,592703,41,9642.43,0,1,0,4,1,2,1,9,1,3,1,0,0,0,5
Medio_bajo,Si_siniestro,619529,99,5299.04,0,0,7,7,7,7,7,35,0,1,1,1,1,1,5
Medio_bajo,No_siniestro,626484,25,1927.79,0,0,0,0,0,0,0,0,1,1,0,1,1,1,5
Medio_bajo,No_siniestro,635541,7,8335.76,0,0,0,0,0,0,0,0,0,1,1,1,1,1,5
Medio_bajo,No_siniestro,666682,24,4122.77,0,0,0,0,0,0,0,0,0,0,0,3,1,1,5
Medio_bajo,No_siniestro,684639,81,2698.29,0,0,0,0,0,0,0,0,2,2,0,1,0,0,5
Medio_bajo,No_siniestro,721704,67,190.45,0,2,1,0,1,0,0,4,2,1,1,1,0,0,5
Medio_bajo,No_siniestro,773419,35,777.09,0,0,0,0,2,1,0,3,1,1,1,2,0,0,5
Medio_bajo,No_siniestro,779000,43,958.53,0,0,0,0,0,0,2,2,0,0,0,1,2,2,5
Medio_bajo,No_siniestro,299487,53,0,0,0,0,0,0,0,0,0,0,1,1,1,1,1,5
Medio_bajo,No_siniestro,442279,0,221.23,0,0,0,0,0,0,0,0,1,0,0,0,0,4,5
Medio_bajo,No_siniestro,572386,13,366.18,0,2,1,1,1,0,0,5,1,2,2,0,0,0,5
Medio_bajo,No_siniestro,590177,84,0,0,0,0,0,0,0,0,0,0,1,1,1,1,1,5
Medio_bajo,No_siniestro,664045,96,160.73,0,0,0,0,0,0,0,0,0,0,0,1,2,2,5
Medio_bajo,No_siniestro,738446,5,7346.76,0,0,1,0,0,0,0,1,3,1,1,0,0,0,5
Medio_alto,No_siniestro,86502,209,23653.44,118178.45,0,0,0,0,0,1,1,3,2,0,0,0,0,5
Medio_alto,No_siniestro,103312,45,14113.01,0,0,0,0,0,0,0,0,1,1,1,1,1,0,5
Medio_alto,No_siniestro,383084,228,6868.6,40102.68,0,0,0,0,0,0,0,1,1,1,1,1,0,5
Medio_alto,No_siniestro,622385,56,12791.37,0,0,0,0,0,0,0,0,0,0,3,1,1,0,5
Medio,No_siniestro,55281,8,15099.64,0,0,0,0,0,0,0,0,1,0,0,2,1,1,5
Medio,Si_siniestro,179538,85,2496.52,0,1,0,0,0,1,0,2,3,1,0,1,0,0,5
Medio,No_siniestro,637472,9,248.25,0,0,0,0,0,0,1,1,1,1,1,1,1,0,5
Medio,Si_siniestro,787524,6,598.04,0,0,0,1,0,1,0,2,1,1,1,1,1,0,5
Bajo,Si_siniestro,28819,10,1829.21,0,1,0,1,0,0,0,2,3,2,0,0,0,0,5
Bajo,No_siniestro,34697,48,873.86,0,0,0,0,0,0,0,0,4,1,0,0,0,0,5
Bajo,No_siniestro,54133,8,133.12,0,0,0,0,1,1,0,2,1,1,1,1,1,0,5
Bajo,Si_siniestro,62608,100,0.77,0,0,0,0,0,2,1,3,1,1,1,1,1,0,5
Bajo,No_siniestro,100650,39,1602.24,0,0,0,0,0,0,1,1,1,1,1,1,1,0,5
Bajo,Si_siniestro,237580,49,1682.29,0,0,0,0,1,0,0,1,1,2,1,1,0,0,5
Bajo,Si_siniestro,237593,9,442.32,0,1,1,0,0,0,0,2,2,2,1,0,0,0,5
Bajo,No_siniestro,314771,24,1021.11,0,0,0,0,0,0,0,0,0,1,1,1,1,1,5
Bajo,No_siniestro,342204,81,605.56,0,2,1,0,0,0,0,3,1,1,1,2,0,0,5
Bajo,No_siniestro,360887,18,3227.65,0,0,2,2,1,0,0,5,0,2,2,1,0,0,5
Bajo,Si_siniestro,428130,44,1013.22,0,2,1,1,1,1,0,6,2,2,1,0,0,0,5
Bajo,No_siniestro,445957,22,1689.22,14249.78,0,0,0,0,0,0,0,1,1,1,1,1,0,5
Bajo,No_siniestro,463899,27,318.96,0,0,0,0,0,0,0,0,1,1,1,1,1,0,5
Bajo,No_siniestro,495306,50,135.07,0,0,0,0,0,0,0,0,1,1,1,1,0,1,5
Bajo,Si_siniestro,498934,25,1467.11,0,0,0,0,0,0,0,0,0,0,0,0,0,5,5
Bajo,No_siniestro,587069,23,1176.05,0,0,0,0,0,0,0,0,0,1,1,1,1,1,5
Bajo,No_siniestro,631971,25,102.95,0,0,0,0,0,0,0,0,0,1,1,1,1,1,5
Bajo,Si_siniestro,693827,7,465.7,0,2,1,1,0,0,0,4,2,2,1,0,0,0,5
Bajo,No_siniestro,709957,18,770.6,0,0,0,0,0,0,0,0,0,0,2,1,1,1,5
Bajo,Si_siniestro,725255,7,1486.05,0,2,2,1,1,1,1,8,1,2,2,0,0,0,5
Bajo,Si_siniestro,739640,43,581.51,0,1,1,1,0,0,0,3,2,1,1,1,0,0,5
Bajo,Si_siniestro,769120,43,1444.15,0,0,0,0,0,0,0,0,3,1,1,0,0,0,5
Bajo,No_siniestro,124176,3,2305.2,0,0,0,1,0,0,0,1,1,1,1,1,0,1,5
Bajo,No_siniestro,546540,42,4909.54,0,4,3,2,1,0,0,10,1,1,1,1,1,0,5
Bajo,No_siniestro,552878,0,2202.01,0,0,0,0,0,0,0,0,0,1,1,1,1,1,5
Bajo,No_siniestro,564585,1,279.88,0,0,0,0,0,0,0,0,0,1,1,1,1,1,5
Moderado,No_siniestro,9591,118,18795.63,0,0,0,0,0,1,0,1,0,0,0,2,1,1,4
Moderado,No_siniestro,421746,28,174.22,100157.6,0,0,0,0,0,0,0,0,0,1,1,1,1,4
Medio_bajo,No_siniestro,16302,62,3905.43,0,0,0,0,1,1,0,2,0,0,2,0,0,2,4
Medio_bajo,No_siniestro,81041,67,7397.11,0,0,2,1,2,1,1,7,0,1,1,1,1,0,4
Medio_bajo,No_siniestro,132734,13,773.04,0,0,0,0,0,0,1,1,0,1,1,1,0,1,4
Medio_bajo,No_siniestro,139515,105,2620.33,0,0,0,0,0,0,0,0,0,0,1,1,1,1,4
Medio_bajo,No_siniestro,220849,17,4353.74,0,0,0,0,0,0,2,2,0,0,0,0,3,1,4
Medio_bajo,Si_siniestro,228812,7,2247.23,0,2,1,0,0,0,0,3,2,1,0,0,1,0,4
Medio_bajo,Si_siniestro,236124,120,530.61,0,1,0,0,0,0,0,1,2,1,1,0,0,0,4
Medio_bajo,Si_siniestro,240349,20,6809.8,0,0,1,1,1,2,1,6,1,0,0,0,1,2,4
Medio_bajo,No_siniestro,240437,7,8778.57,0,0,0,0,0,0,0,0,2,1,1,0,0,0,4
Medio_bajo,No_siniestro,274625,89,685.94,0,2,1,1,1,1,0,6,0,0,0,2,1,1,4
Medio_bajo,No_siniestro,277864,27,692.39,0,0,0,0,0,0,0,0,0,0,1,1,1,1,4
Medio_bajo,No_siniestro,277980,49,216.29,0,0,0,0,1,1,1,3,0,0,0,1,1,2,4
Medio_bajo,No_siniestro,303236,6,94.55,17602.77,0,0,0,0,0,0,0,1,1,1,1,0,0,4
Medio_bajo,No_siniestro,342055,13,2.52,0,0,0,0,0,0,0,0,0,0,1,1,1,1,4
Medio_bajo,Si_siniestro,361000,44,712.07,0,3,2,1,0,0,0,6,3,1,0,0,0,0,4
Medio_bajo,No_siniestro,380066,31,4615.05,0,0,0,0,0,0,0,0,0,1,1,1,1,0,4
Medio_bajo,No_siniestro,424293,81,4826.36,0,1,1,1,0,1,1,5,0,0,0,2,2,0,4
Medio_bajo,Si_siniestro,426700,44,421.14,0,2,1,2,1,0,1,7,1,0,1,1,1,0,4
Medio_bajo,No_siniestro,524863,15,307.78,0,0,0,0,0,0,0,0,1,1,1,1,0,0,4
Medio_bajo,No_siniestro,620511,32,5786.12,0,0,0,0,0,0,0,0,0,0,0,0,1,3,4
Medio_bajo,Si_siniestro,623327,139,4159.92,0,1,7,7,7,7,7,36,1,2,1,0,0,0,4
Medio_bajo,No_siniestro,631566,37,325.48,0,1,1,1,0,1,1,5,0,1,1,1,1,0,4
Medio_bajo,No_siniestro,669083,8,2052.81,0,0,0,0,0,0,0,0,1,1,1,0,0,1,4
Medio_bajo,No_siniestro,674020,43,4778.93,0,0,0,0,0,0,0,0,1,1,0,0,1,1,4
Medio_bajo,No_siniestro,675197,6,1099.02,0,0,0,0,0,0,0,0,1,1,1,0,0,1,4
Medio_bajo,Si_siniestro,695135,69,3446.58,0,2,1,0,0,0,0,3,2,2,0,0,0,0,4
Medio_bajo,No_siniestro,702108,22,871.53,0,0,1,0,0,0,0,1,1,1,1,0,0,1,4
Medio_bajo,No_siniestro,734268,6,12443.63,28332.59,0,0,0,0,0,0,0,0,2,2,0,0,0,4
Medio_bajo,No_siniestro,736658,164,3399.34,59582.94,0,2,0,0,0,0,2,0,0,0,2,1,1,4
Medio_bajo,No_siniestro,754213,64,6164.75,0,0,0,1,0,0,0,1,0,0,0,0,2,2,4
Medio_bajo,No_siniestro,773269,31,14355.93,0,1,0,0,0,0,0,1,2,1,1,0,0,0,4
Medio_bajo,No_siniestro,7580,43,4275.62,0,0,0,0,0,0,0,0,2,2,0,0,0,0,4
Medio_bajo,No_siniestro,229730,42,2815.7,0,0,0,0,0,0,0,0,0,0,1,1,1,1,4
Medio_bajo,No_siniestro,336322,11,1730.65,0,0,7,7,7,6,5,32,1,0,1,1,1,0,4
Medio_bajo,No_siniestro,356985,34,430.23,0,1,1,0,1,0,1,4,1,0,1,1,0,1,4
Medio_bajo,No_siniestro,439727,3,1831.68,0,0,0,0,0,0,0,0,2,1,1,0,0,0,4
Medio_bajo,No_siniestro,564262,3,112.19,0,0,0,0,0,0,0,0,0,0,1,1,1,1,4
Medio_bajo,No_siniestro,594625,21,23771.28,0,0,0,0,0,0,0,0,0,0,2,1,1,0,4
Medio_bajo,No_siniestro,633942,5,953.37,0,0,0,0,0,0,0,0,3,1,0,0,0,0,4
Medio_bajo,No_siniestro,642587,5,3310.75,0,1,0,1,0,0,0,2,3,0,0,0,0,1,4
Medio_bajo,No_siniestro,654086,48,0,0,0,0,0,0,0,0,0,2,2,0,0,0,0,4
Medio_bajo,No_siniestro,692937,1,2699.14,48711.27,0,0,0,0,0,0,0,0,0,2,1,1,0,4
Medio_alto,No_siniestro,219141,114,91.39,0,0,0,0,0,0,0,0,2,1,1,0,0,0,4
Medio_alto,No_siniestro,413923,78,2630.79,0,1,0,2,1,0,2,6,0,0,1,1,0,2,4
Medio_alto,No_siniestro,691790,43,8424.12,0,0,0,0,0,0,0,0,0,0,1,1,1,1,4
Bajo,No_siniestro,10664,98,1277.87,0,0,0,1,1,0,0,2,1,1,1,1,0,0,4
Bajo,No_siniestro,58993,9,768.22,0,0,0,0,0,0,0,0,1,1,1,1,0,0,4
Bajo,Si_siniestro,96938,12,680.8,0,2,2,1,1,1,1,8,2,1,0,0,0,1,4
Bajo,No_siniestro,104935,23,3909.63,0,0,1,0,1,1,0,3,0,1,0,1,1,1,4
Bajo,No_siniestro,112684,14,1118.58,0,0,0,0,0,0,0,0,1,1,1,1,0,0,4
Bajo,No_siniestro,139697,45,798.12,0,1,0,0,0,0,0,1,2,1,1,0,0,0,4
Bajo,Si_siniestro,159498,17,3025.97,0,0,0,0,0,1,0,1,1,0,0,1,1,1,4
Bajo,Si_siniestro,161720,39,812.74,0,3,2,1,1,0,0,7,2,1,0,0,1,0,4
Bajo,No_siniestro,225336,35,648.48,0,0,0,0,0,0,0,0,1,0,1,1,1,0,4
Bajo,No_siniestro,274174,50,2717,0,0,0,0,0,0,0,0,0,0,1,1,1,1,4
Bajo,Si_siniestro,304026,17,679.01,0,3,2,1,1,1,1,9,2,2,0,0,0,0,4
Bajo,Si_siniestro,307621,13,1370.78,0,1,1,1,1,2,1,7,0,0,0,2,1,1,4
Bajo,Si_siniestro,360472,7,2263.93,0,2,1,1,0,0,1,5,1,0,1,0,0,2,4
Bajo,No_siniestro,396399,8,831.85,0,0,0,0,0,0,0,0,1,1,1,1,0,0,4
Bajo,Si_siniestro,497776,104,4333.42,0,3,2,1,1,0,0,7,3,1,0,0,0,0,4
Bajo,No_siniestro,506897,39,587.37,0,1,0,1,0,1,0,3,1,1,0,0,2,0,4
Bajo,Si_siniestro,526862,63,3138.02,0,1,0,0,4,3,2,10,1,1,1,0,0,1,4
Bajo,No_siniestro,538265,13,1446.56,0,1,1,0,0,0,0,2,1,1,1,1,0,0,4
Bajo,Si_siniestro,554551,15,890.84,0,3,2,1,0,0,0,6,4,0,0,0,0,0,4
Bajo,No_siniestro,587489,120,982.22,0,0,0,0,0,0,0,0,0,0,1,1,1,1,4
Bajo,No_siniestro,637000,43,1612.04,0,1,0,0,0,0,0,1,2,0,1,1,0,0,4
Bajo,No_siniestro,669809,6,976,0,1,0,0,0,0,0,1,2,2,0,0,0,0,4
Bajo,Si_siniestro,671536,116,2959.32,0,2,1,1,0,0,0,4,1,1,2,0,0,0,4
Bajo,No_siniestro,742396,20,3359.46,0,0,1,0,0,0,0,1,0,1,1,0,1,1,4
Bajo,No_siniestro,762533,64,2062.9,0,1,1,1,0,1,0,4,2,1,1,0,0,0,4
Bajo,No_siniestro,38316,32,0,0,0,0,0,0,0,0,0,1,0,0,1,1,1,4
Bajo,No_siniestro,298375,4,724.07,0,3,2,1,0,0,0,6,2,1,1,0,0,0,4
Bajo,No_siniestro,311601,3,167.89,0,0,0,0,0,0,0,0,2,1,1,0,0,0,4
Bajo,No_siniestro,531155,2,984.64,0,0,0,0,0,0,0,0,0,0,1,1,1,1,4
Bajo,No_siniestro,554685,6,334.46,0,0,0,0,0,0,0,0,1,1,1,1,0,0,4
Bajo,No_siniestro,629849,1,891.93,0,0,0,0,0,0,0,0,2,2,0,0,0,0,4
Bajo,No_siniestro,689192,1,1986.27,0,0,0,0,0,0,0,0,0,0,1,1,1,1,4
Bajo,No_siniestro,718719,1,2432.65,0,0,0,0,0,0,0,0,0,0,1,1,1,1,4
Moderado,Si_siniestro,68729,101,7916.86,0,0,0,0,1,0,0,1,1,0,1,0,1,0,3
Moderado,No_siniestro,223204,15,38398.55,0,0,1,0,1,1,1,4,1,1,1,0,0,0,3
Moderado,No_siniestro,357223,7,13.58,121444.02,0,0,0,0,0,0,0,0,0,0,0,2,1,3
Moderado,No_siniestro,394812,41,5654.74,0,0,0,0,0,0,0,0,1,1,0,1,0,0,3
Moderado,No_siniestro,489393,34,19019.79,0,1,0,0,0,1,1,3,0,0,0,1,1,1,3
Moderado,No_siniestro,550353,157,12057.12,66506.44,0,0,0,0,0,0,0,2,1,0,0,0,0,3
Moderado,No_siniestro,666771,204,32850.57,114965.99,0,0,0,0,0,0,0,1,1,1,0,0,0,3
Moderado,No_siniestro,413224,75,17.83,37231.18,0,0,0,0,0,0,0,1,1,1,0,0,0,3
Medio_bajo,No_siniestro,676,76,216.52,0,0,0,1,0,0,0,1,0,0,0,1,1,1,3
Medio_bajo,Si_siniestro,19143,14,1056.93,0,0,0,1,0,0,0,1,1,0,1,1,0,0,3
Medio_bajo,No_siniestro,82870,39,1564.59,0,0,0,0,0,0,1,1,1,1,1,0,0,0,3
Medio_bajo,Si_siniestro,91839,34,12809.11,0,1,0,1,0,1,0,3,1,1,0,0,1,0,3
Medio_bajo,No_siniestro,94381,16,1771.2,0,0,0,0,0,0,0,0,0,0,0,1,1,1,3
Medio_bajo,No_siniestro,96121,35,1322.35,0,0,0,0,0,0,1,1,2,0,0,0,0,1,3
Medio_bajo,No_siniestro,133921,58,1922.18,0,0,0,0,0,0,0,0,2,1,0,0,0,0,3
Medio_bajo,Si_siniestro,195729,53,2268.2,0,0,0,0,0,0,0,0,0,0,2,1,0,0,3
Medio_bajo,Si_siniestro,210570,49,2715.92,0,0,7,6,5,4,3,25,1,1,1,0,0,0,3
Medio_bajo,No_siniestro,215343,95,206.52,0,0,0,0,0,0,0,0,0,0,0,1,1,1,3
Medio_bajo,Si_siniestro,219945,24,287.54,22832.65,1,0,0,0,0,0,1,1,0,1,0,1,0,3
Medio_bajo,No_siniestro,247571,67,1162.38,0,0,0,0,0,0,0,0,0,0,0,0,0,3,3
Medio_bajo,No_siniestro,260064,84,22.78,0,0,0,0,0,0,0,0,0,0,0,1,1,1,3
Medio_bajo,No_siniestro,287507,7,1823.94,0,1,1,1,1,0,0,4,0,1,1,1,0,0,3
Medio_bajo,No_siniestro,297814,27,9442.01,0,0,0,0,0,0,0,0,0,0,1,0,0,2,3
Medio_bajo,Si_siniestro,317629,50,1186.63,0,2,1,1,1,0,0,5,1,0,1,1,0,0,3
Medio_bajo,No_siniestro,342044,31,776.95,44066.17,0,0,0,0,0,0,0,0,0,0,1,1,1,3
Medio_bajo,No_siniestro,346799,26,4326.65,0,0,0,0,0,0,0,0,3,0,0,0,0,0,3
Medio_bajo,No_siniestro,363612,29,1231.65,0,0,0,0,0,0,0,0,0,0,0,0,0,3,3
Medio_bajo,No_siniestro,377406,58,14.98,0,0,0,0,0,0,0,0,0,0,0,1,1,1,3
Medio_bajo,No_siniestro,403783,58,7947.56,107834.81,0,0,0,0,0,0,0,1,1,1,0,0,0,3
Medio_bajo,No_siniestro,409207,10,828.21,0,0,0,0,0,1,0,1,1,0,1,0,0,1,3
Medio_bajo,Si_siniestro,427837,50,3778.8,0,3,2,2,1,1,1,10,0,0,0,1,1,1,3
Medio_bajo,No_siniestro,547981,101,19809.51,0,0,0,0,0,1,1,2,0,0,0,1,1,1,3
Medio_bajo,Si_siniestro,548101,45,16.57,0,2,1,0,0,0,0,3,0,1,1,1,0,0,3
Medio_bajo,Si_siniestro,557901,39,938.83,0,0,0,0,1,0,1,2,0,1,1,0,0,1,3
Medio_bajo,No_siniestro,559385,45,6952.05,0,0,0,0,1,0,0,1,0,0,0,1,1,1,3
Medio_bajo,Si_siniestro,569772,29,17740.51,0,2,1,1,1,1,0,6,2,0,0,1,0,0,3
Medio_bajo,Si_siniestro,585120,40,509.22,0,1,1,0,0,0,0,2,2,1,0,0,0,0,3
Medio_bajo,No_siniestro,593010,40,1945.2,0,0,0,0,0,0,0,0,2,1,0,0,0,0,3
Medio_bajo,No_siniestro,600578,9,6712.26,0,0,0,0,0,0,0,0,0,1,0,0,1,1,3
Medio_bajo,Si_siniestro,612310,40,12030.09,0,3,2,1,0,0,0,6,3,0,0,0,0,0,3
Medio_bajo,No_siniestro,672223,31,6123.65,0,0,0,1,0,0,0,1,0,0,3,0,0,0,3
Medio_bajo,Si_siniestro,692444,11,558.9,0,0,0,0,0,0,1,1,0,0,0,1,1,1,3
Medio_bajo,No_siniestro,692484,34,2115.4,0,2,1,1,0,0,0,4,1,1,1,0,0,0,3
Medio_bajo,No_siniestro,695647,100,1637.32,0,0,0,0,0,0,0,0,0,0,0,1,1,1,3
Medio_bajo,No_siniestro,697799,23,1855.77,0,0,0,0,0,0,0,0,0,0,0,1,1,1,3
Medio_bajo,No_siniestro,724322,11,0.2,0,0,7,7,7,6,5,32,0,0,0,1,1,1,3
Medio_bajo,No_siniestro,740087,38,2219.57,0,1,0,1,0,0,0,2,1,1,1,0,0,0,3
Medio_bajo,No_siniestro,759430,43,25.53,89195.53,0,0,0,0,0,0,0,0,0,0,1,1,1,3
Medio_bajo,No_siniestro,759926,17,11576.94,0,1,1,1,0,1,0,4,2,0,0,1,0,0,3
Medio_bajo,No_siniestro,761327,7,6204.88,0,0,0,0,0,0,0,0,0,0,0,1,1,1,3
Medio_bajo,No_siniestro,765522,36,3975.51,64901.59,1,1,1,1,1,2,7,0,0,0,0,2,1,3
Medio_bajo,No_siniestro,775261,20,9095.65,0,0,0,0,0,0,0,0,1,0,0,0,1,1,3
Medio_bajo,No_siniestro,114500,42,1391.52,0,2,1,0,0,0,0,3,2,1,0,0,0,0,3
Medio_bajo,No_siniestro,165452,48,17.49,0,6,5,4,3,2,1,21,1,1,1,0,0,0,3
Medio_bajo,No_siniestro,319455,13,389.86,0,0,0,1,1,0,0,2,0,1,1,1,0,0,3
Medio_bajo,No_siniestro,346002,103,0,0,0,0,0,0,0,0,0,1,1,0,0,0,1,3
Medio_bajo,No_siniestro,490528,0,1181.02,53405.65,0,0,0,0,0,0,0,1,1,1,0,0,0,3
Medio_bajo,No_siniestro,549466,33,213.34,0,1,0,0,0,1,1,3,0,0,0,0,2,1,3
Medio_bajo,No_siniestro,574575,7,2526.03,0,0,0,1,1,1,1,4,0,1,1,1,0,0,3
Medio_bajo,No_siniestro,588497,61,0,0,0,0,0,0,0,1,1,0,0,0,0,2,1,3
Medio_bajo,No_siniestro,645003,1,390.04,0,0,0,0,0,0,0,0,0,0,0,1,1,1,3
Medio_bajo,No_siniestro,743095,88,806.47,0,1,1,0,0,0,0,2,1,1,1,0,0,0,3
Medio_alto,No_siniestro,16170,39,10102.03,0,0,0,0,0,1,1,2,0,0,1,1,1,0,3
Medio_alto,No_siniestro,86776,65,813.24,0,0,0,0,1,0,1,2,0,0,1,1,0,1,3
Medio_alto,No_siniestro,722658,68,1161.42,0,0,0,0,0,0,0,0,1,1,1,0,0,0,3
Medio,Si_siniestro,55717,12,1032.58,0,0,0,0,0,1,1,2,0,0,1,1,0,1,3
Medio,No_siniestro,178709,10,104.3,0,0,0,0,0,0,0,0,0,0,0,1,1,1,3
Medio,No_siniestro,434159,42,6941.66,0,0,0,0,0,0,0,0,0,0,2,1,0,0,3
Medio,No_siniestro,447229,9,1438,0,0,0,0,0,0,0,0,0,0,0,2,1,0,3
Medio,No_siniestro,556005,71,1225.32,0,0,0,0,1,0,0,1,1,1,1,0,0,0,3
Medio,Si_siniestro,716850,43,1068.87,0,2,1,1,1,0,0,5,1,1,1,0,0,0,3
Medio,No_siniestro,507605,47,2078.18,0,1,4,3,2,1,0,11,0,0,0,0,1,2,3
Medio,No_siniestro,508680,42,335.06,0,0,0,0,0,0,0,0,0,0,0,0,1,2,3
Medio,No_siniestro,709497,4,1213.03,0,1,2,1,0,0,0,4,1,1,1,0,0,0,3
Bajo,No_siniestro,28317,26,1560.06,0,0,0,0,0,0,0,0,1,0,0,1,1,0,3
Bajo,No_siniestro,60094,6,1807.61,0,1,1,0,1,0,0,3,2,0,0,1,0,0,3
Bajo,No_siniestro,83224,14,1400.2,0,1,0,0,0,0,0,1,1,0,1,1,0,0,3
Bajo,No_siniestro,91933,13,367.08,0,0,0,0,0,0,0,0,1,1,1,0,0,0,3
Bajo,No_siniestro,122010,39,272.95,0,0,0,0,0,0,0,0,0,0,1,1,0,1,3
Bajo,Si_siniestro,172565,8,1833.79,0,0,0,0,0,0,0,0,1,1,1,0,0,0,3
Bajo,No_siniestro,175381,31,1593.34,0,0,0,0,0,0,0,0,1,1,1,0,0,0,3
Bajo,No_siniestro,175590,49,176.17,0,1,1,1,0,1,0,4,1,1,1,0,0,0,3
Bajo,Si_siniestro,187175,6,1062.81,0,1,1,1,1,1,0,5,1,1,1,0,0,0,3
Bajo,No_siniestro,191018,55,1394.26,0,0,0,0,0,0,0,0,1,1,1,0,0,0,3
Bajo,Si_siniestro,219341,52,2176,0,2,1,0,0,0,0,3,2,1,0,0,0,0,3
Bajo,No_siniestro,223253,77,1891.2,0,0,0,0,0,0,0,0,1,0,2,0,0,0,3
Bajo,No_siniestro,245737,8,192.99,0,0,0,0,0,0,0,0,1,0,0,0,1,1,3
Bajo,No_siniestro,249587,11,962.27,0,0,0,0,0,0,0,0,0,0,0,1,1,1,3
Bajo,No_siniestro,253932,14,2674.64,0,0,0,0,0,1,0,1,0,0,0,2,1,0,3
Bajo,Si_siniestro,291788,6,2306.79,0,3,2,1,0,0,0,6,2,1,0,0,0,0,3
Bajo,Si_siniestro,308240,49,971.44,0,0,0,0,0,0,0,0,2,1,0,0,0,0,3
Bajo,Si_siniestro,311278,14,518.4,0,1,1,1,0,0,0,3,0,0,0,1,1,1,3
Bajo,No_siniestro,318744,47,1123.05,0,0,0,0,0,0,0,0,2,1,0,0,0,0,3
Bajo,No_siniestro,325321,8,837.49,0,1,1,0,0,0,0,2,1,1,1,0,0,0,3
Bajo,No_siniestro,327261,15,1320.24,0,0,0,0,0,0,0,0,0,0,0,1,1,1,3
Bajo,Si_siniestro,372754,16,735.11,0,1,0,1,0,0,0,2,0,1,1,0,1,0,3
Bajo,No_siniestro,376279,46,204.21,0,0,0,0,0,0,0,0,0,0,2,1,0,0,3
Bajo,Si_siniestro,400102,155,312.08,0,0,1,2,1,1,0,5,1,0,1,1,0,0,3
Bajo,Si_siniestro,405752,7,1483.64,0,2,2,1,1,1,0,7,2,1,0,0,0,0,3
Bajo,No_siniestro,408883,7,1352.16,0,0,1,1,1,1,1,5,0,0,1,1,1,0,3
Bajo,No_siniestro,418825,22,14123.75,0,0,0,0,0,0,0,0,0,0,0,1,1,1,3
Bajo,No_siniestro,427536,62,2263.13,0,0,0,1,0,0,0,1,0,2,1,0,0,0,3
Bajo,No_siniestro,431109,28,519.07,0,0,0,0,0,0,0,0,0,0,1,0,0,2,3
Bajo,No_siniestro,488413,66,393.36,0,1,0,1,0,0,0,2,1,1,1,0,0,0,3
Bajo,No_siniestro,502211,12,2324.99,0,0,0,0,0,0,0,0,0,0,0,0,2,1,3
Bajo,No_siniestro,506386,16,1306.76,0,0,1,0,0,0,0,1,0,0,0,1,1,1,3
Bajo,No_siniestro,507189,19,79.04,0,0,0,0,0,0,0,0,0,0,1,1,1,0,3
Bajo,Si_siniestro,552605,30,1326.06,0,1,1,1,0,0,0,3,0,0,0,0,2,1,3
Bajo,No_siniestro,570515,6,148.82,0,0,1,1,1,0,0,3,1,1,1,0,0,0,3
Bajo,No_siniestro,616854,13,1125.51,0,0,0,0,0,0,0,0,2,1,0,0,0,0,3
Bajo,No_siniestro,621027,19,1355.71,0,1,1,0,1,0,1,4,0,2,0,0,0,1,3
Bajo,Si_siniestro,630451,13,453.21,0,1,1,0,0,0,0,2,0,0,1,1,1,0,3
Bajo,Si_siniestro,631729,40,2680.6,0,3,2,1,0,0,0,6,1,2,0,0,0,0,3
Bajo,No_siniestro,635691,17,1330.54,0,0,0,0,1,0,1,2,0,0,1,1,1,0,3
Bajo,No_siniestro,640516,14,403,0,0,0,0,0,0,0,0,1,1,0,0,0,1,3
Bajo,No_siniestro,657912,11,266.03,0,0,0,0,0,0,0,0,0,0,0,1,1,1,3
Bajo,No_siniestro,664694,13,56.11,0,0,0,0,0,0,0,0,0,0,0,1,1,1,3
Bajo,Si_siniestro,713752,7,1439.72,0,1,1,0,2,1,0,5,1,1,0,0,0,1,3
Bajo,Si_siniestro,742187,16,583.55,0,0,0,0,0,0,0,0,1,1,1,0,0,0,3
Bajo,No_siniestro,745930,43,1971.79,0,0,1,1,1,0,0,3,0,1,1,1,0,0,3
Bajo,Si_siniestro,771089,22,1713.77,0,2,1,1,1,1,1,7,1,1,1,0,0,0,3
Bajo,No_siniestro,781301,18,2169.32,0,0,0,0,0,0,0,0,1,1,1,0,0,0,3
Bajo,No_siniestro,787554,12,1824.07,0,0,0,0,0,0,0,0,2,0,0,1,0,0,3
Bajo,No_siniestro,787922,88,322.15,0,0,0,0,0,0,0,0,0,0,0,1,1,1,3
Bajo,Si_siniestro,789789,21,300.85,0,0,0,0,0,0,0,0,1,1,1,0,0,0,3
Bajo,No_siniestro,16982,14,795.24,0,0,0,1,0,0,0,1,0,0,1,1,1,0,3
Bajo,No_siniestro,40242,1,1311.86,0,0,0,0,0,0,0,0,0,0,0,0,2,1,3
Bajo,No_siniestro,55408,56,1385.2,0,0,0,0,0,1,0,1,0,0,0,0,1,2,3
Bajo,No_siniestro,185638,1,1931.92,0,0,0,0,0,0,0,0,1,0,0,0,1,1,3
Bajo,No_siniestro,209470,42,267.4,0,0,0,0,0,0,0,0,0,0,0,1,1,1,3
Bajo,No_siniestro,241048,40,0,0,0,0,0,0,0,0,0,0,0,1,1,1,0,3
Bajo,No_siniestro,243462,8,1206.48,0,2,1,1,0,0,0,4,1,1,1,0,0,0,3
Bajo,No_siniestro,337754,16,3644.73,0,0,0,0,0,0,0,0,1,1,1,0,0,0,3
Bajo,No_siniestro,362833,12,645.79,0,1,1,1,0,0,0,3,1,1,1,0,0,0,3
Bajo,No_siniestro,414800,42,11.71,0,0,0,0,0,0,0,0,1,1,1,0,0,0,3
Bajo,No_siniestro,475060,42,1000.49,0,0,0,0,0,1,0,1,0,0,1,1,1,0,3
Bajo,No_siniestro,515737,64,1929.11,0,2,2,2,1,1,1,9,1,1,1,0,0,0,3
Bajo,No_siniestro,557185,10,1433.23,0,2,1,0,0,0,0,3,3,0,0,0,0,0,3
Bajo,No_siniestro,565121,15,480.22,0,1,1,1,0,1,0,4,1,0,0,1,0,1,3
Bajo,No_siniestro,598449,1,1213.07,0,0,0,0,0,0,0,0,0,0,1,1,1,0,3
Bajo,No_siniestro,645733,0,1288.39,0,0,0,0,0,0,0,0,3,0,0,0,0,0,3
Bajo,No_siniestro,669818,6,2301.37,0,0,0,0,0,0,0,0,0,0,1,1,1,0,3
Bajo,No_siniestro,710863,0,0,0,0,0,0,0,0,0,0,0,0,0,1,1,1,3
Bajo,No_siniestro,756227,1,353.36,0,0,0,0,0,0,0,0,0,0,0,1,1,1,3
Bajo,No_siniestro,758242,9,32.35,0,0,0,0,0,0,0,0,1,1,1,0,0,0,3
Moderado,No_siniestro,610339,123,78751.32,178136.54,0,1,0,0,0,0,1,0,2,0,0,0,0,2
Moderado,No_siniestro,653179,61,53656.86,0,0,0,0,0,0,1,1,1,1,0,0,0,0,2
Medio_bajo,No_siniestro,2022,16,5600.89,0,0,0,0,1,0,0,1,0,0,0,1,0,1,2
Medio_bajo,No_siniestro,8810,39,1378.92,0,0,0,0,0,0,0,0,1,0,0,0,0,1,2
Medio_bajo,No_siniestro,19391,117,2757.37,0,1,0,0,0,1,1,3,1,0,0,0,0,1,2
Medio_bajo,No_siniestro,29564,41,149.81,0,0,0,0,0,0,0,0,1,1,0,0,0,0,2
Medio_bajo,No_siniestro,37575,11,5761.3,0,0,0,0,0,1,1,2,1,0,0,0,1,0,2
Medio_bajo,No_siniestro,38726,24,1898.16,0,0,0,0,0,0,0,0,1,1,0,0,0,0,2
Medio_bajo,No_siniestro,38864,31,325.01,0,0,0,0,0,0,1,1,0,0,1,0,0,1,2
Medio_bajo,No_siniestro,51548,58,1134.84,0,0,0,0,0,1,0,1,0,0,0,1,1,0,2
Medio_bajo,No_siniestro,64750,39,5691.88,0,0,0,0,0,0,0,0,0,0,0,0,1,1,2
Medio_bajo,No_siniestro,79871,123,275.45,0,0,0,0,0,0,0,0,1,1,0,0,0,0,2
Medio_bajo,Si_siniestro,101679,8,5043.51,0,1,1,2,1,0,0,5,1,0,1,0,0,0,2
Medio_bajo,No_siniestro,101974,43,114.18,0,0,0,0,0,0,0,0,0,0,0,1,1,0,2
Medio_bajo,Si_siniestro,102735,6,12131.58,0,2,1,0,0,0,0,3,2,0,0,0,0,0,2
Medio_bajo,No_siniestro,107666,18,457.33,0,0,0,0,0,0,0,0,1,1,0,0,0,0,2
Medio_bajo,No_siniestro,110241,62,2635.55,0,0,0,0,0,0,0,0,2,0,0,0,0,0,2
Medio_bajo,No_siniestro,124166,17,9028,0,0,0,0,0,0,0,0,1,0,0,1,0,0,2
Medio_bajo,No_siniestro,164058,24,4649.22,0,0,0,0,0,0,0,0,0,0,0,0,1,1,2
Medio_bajo,Si_siniestro,181882,13,1957.51,0,2,1,1,2,1,1,8,1,0,0,1,0,0,2
Medio_bajo,No_siniestro,193501,40,2086.21,0,0,0,0,0,0,0,0,1,1,0,0,0,0,2
Medio_bajo,No_siniestro,203319,161,788.2,0,0,1,1,0,1,0,3,1,0,0,1,0,0,2
Medio_bajo,No_siniestro,206531,14,6295.65,0,0,0,0,0,0,0,0,1,0,1,0,0,0,2
Medio_bajo,No_siniestro,212955,58,1478.6,0,0,0,0,0,0,0,0,0,0,0,0,2,0,2
Medio_bajo,No_siniestro,224667,18,518.67,0,1,1,1,1,1,1,6,0,1,1,0,0,0,2
Medio_bajo,Si_siniestro,224940,49,575.8,0,0,0,0,0,0,0,0,1,1,0,0,0,0,2
Medio_bajo,No_siniestro,225733,84,950.13,0,0,0,0,0,0,0,0,1,0,0,0,1,0,2
Medio_bajo,No_siniestro,234356,14,2299.72,0,0,0,0,0,0,0,0,1,0,0,1,0,0,2
Medio_bajo,No_siniestro,234813,26,13507.5,0,0,1,0,0,0,0,1,0,0,0,0,1,1,2
Medio_bajo,No_siniestro,266509,50,646.95,0,1,0,0,0,0,0,1,1,0,1,0,0,0,2
Medio_bajo,No_siniestro,284137,63,188.84,0,0,0,0,1,0,0,1,0,0,1,1,0,0,2
Medio_bajo,No_siniestro,293985,8,3750.57,0,0,0,0,0,0,0,0,0,1,1,0,0,0,2
Medio_bajo,Si_siniestro,297873,57,3100.59,0,1,0,0,0,0,0,1,1,0,0,0,0,1,2
Medio_bajo,No_siniestro,314741,14,791.67,0,0,0,0,0,0,0,0,1,0,1,0,0,0,2
Medio_bajo,Si_siniestro,328886,45,903.43,0,0,1,0,0,1,1,3,1,1,0,0,0,0,2
Medio_bajo,No_siniestro,329635,27,12901.61,0,0,1,0,0,0,0,1,1,0,0,0,1,0,2
Medio_bajo,No_siniestro,329666,120,19126.18,0,0,0,0,0,0,0,0,0,0,2,0,0,0,2
Medio_bajo,No_siniestro,372115,20,859.48,0,0,0,0,0,0,0,0,0,0,0,0,1,1,2
Medio_bajo,No_siniestro,382520,44,317.35,0,0,0,0,0,0,0,0,1,1,0,0,0,0,2
Medio_bajo,No_siniestro,400830,44,12549.59,35206.65,0,0,0,0,0,0,0,1,1,0,0,0,0,2
Medio_bajo,No_siniestro,403705,75,5737.17,0,0,0,0,0,1,0,1,0,0,0,0,1,1,2
Medio_bajo,No_siniestro,418175,62,1535.37,0,1,2,1,0,0,0,4,0,0,0,1,0,1,2
Medio_bajo,No_siniestro,430850,44,1601.93,0,0,0,0,0,0,0,0,0,0,1,0,0,1,2
Medio_bajo,No_siniestro,450915,113,5.2,0,0,0,0,0,0,0,0,1,1,0,0,0,0,2
Medio_bajo,No_siniestro,453734,43,1157.46,0,0,0,0,0,0,0,0,0,0,0,0,0,2,2
Medio_bajo,Si_siniestro,480949,23,11565.01,0,1,1,1,1,1,0,5,1,1,0,0,0,0,2
Medio_bajo,No_siniestro,484166,7,1523.72,0,0,0,0,2,2,1,5,0,0,0,1,1,0,2
Medio_bajo,No_siniestro,489729,41,506.97,0,0,0,1,0,0,0,1,1,1,0,0,0,0,2
Medio_bajo,No_siniestro,503404,58,7296.73,0,0,0,0,0,0,0,0,0,0,0,0,1,1,2
Medio_bajo,No_siniestro,510811,40,989.91,0,0,0,1,0,0,0,1,1,1,0,0,0,0,2
Medio_bajo,No_siniestro,511935,16,2430.05,0,0,0,0,0,0,0,0,0,0,0,0,1,1,2
Medio_bajo,No_siniestro,547322,63,4771.75,0,0,1,1,0,0,0,2,0,0,0,0,1,1,2
Medio_bajo,Si_siniestro,551215,10,803.45,0,0,0,0,0,0,0,0,0,1,1,0,0,0,2
Medio_bajo,Si_siniestro,556457,11,8200.77,0,2,1,0,0,0,0,3,2,0,0,0,0,0,2
Medio_bajo,No_siniestro,560723,106,8065.69,18727.69,0,1,0,1,0,1,3,0,1,1,0,0,0,2
Medio_bajo,No_siniestro,565525,23,2077.25,0,0,0,0,0,0,0,0,0,0,0,0,2,0,2
Medio_bajo,No_siniestro,578492,95,5881.05,0,0,0,0,0,0,0,0,0,0,0,0,0,2,2
Medio_bajo,No_siniestro,586030,40,785.43,0,1,1,1,0,1,0,4,0,0,1,1,0,0,2
Medio_bajo,No_siniestro,593149,35,2345.99,0,0,0,0,0,0,0,0,2,0,0,0,0,0,2
Medio_bajo,No_siniestro,594323,123,515.38,0,0,0,1,0,0,1,2,0,1,0,0,1,0,2
Medio_bajo,No_siniestro,606219,26,3037.72,0,0,0,0,0,0,0,0,1,0,0,0,1,0,2
Medio_bajo,No_siniestro,607565,106,190.04,0,0,0,0,0,0,0,0,1,1,0,0,0,0,2
Medio_bajo,Si_siniestro,616682,29,13616.95,0,0,0,0,1,1,0,2,0,0,1,1,0,0,2
Medio_bajo,No_siniestro,652249,31,19379.62,0,0,1,0,0,0,0,1,1,1,0,0,0,0,2
Medio_bajo,No_siniestro,654105,117,3233.83,0,0,0,0,0,0,0,0,1,1,0,0,0,0,2
Medio_bajo,Si_siniestro,667992,52,735.08,0,0,0,0,0,0,1,1,0,0,0,1,1,0,2
Medio_bajo,No_siniestro,673542,15,2602.73,0,0,0,0,0,0,1,1,0,0,0,1,1,0,2
Medio_bajo,No_siniestro,674024,26,6654.06,0,0,0,0,0,0,0,0,1,1,0,0,0,0,2
Medio_bajo,No_siniestro,703106,23,167.34,0,0,0,0,0,0,0,0,1,1,0,0,0,0,2
Medio_bajo,No_siniestro,708796,8,5408.11,0,0,0,0,0,0,0,0,0,0,0,1,1,0,2
Medio_bajo,No_siniestro,709742,21,388.86,12934.86,0,0,0,0,0,0,0,1,1,0,0,0,0,2
Medio_bajo,No_siniestro,723341,65,1869.71,0,0,0,0,1,1,1,3,0,0,0,0,1,1,2
Medio_bajo,No_siniestro,728341,135,1770.3,0,0,1,0,0,0,0,1,0,1,1,0,0,0,2
Medio_bajo,No_siniestro,735233,11,659.06,0,0,0,0,1,1,1,3,0,0,0,0,1,1,2
Medio_bajo,No_siniestro,746248,7,80.32,0,0,0,0,0,0,0,0,0,1,1,0,0,0,2
Medio_bajo,No_siniestro,780967,55,3661.48,0,0,0,0,0,0,0,0,2,0,0,0,0,0,2
Medio_bajo,No_siniestro,786468,7,242.1,0,0,0,0,0,0,0,0,0,0,0,0,1,1,2
Medio_bajo,No_siniestro,1141,0,768.98,0,0,0,0,0,0,0,0,0,0,0,0,0,2,2
Medio_bajo,No_siniestro,51024,1,3245.95,0,0,0,0,0,0,0,0,1,0,0,0,0,1,2
Medio_bajo,No_siniestro,91994,1,4009.69,0,0,0,0,0,0,0,0,1,0,0,0,1,0,2
Medio_bajo,No_siniestro,119804,26,1495.65,0,1,0,0,0,0,1,2,1,0,0,0,0,1,2
Medio_bajo,No_siniestro,167169,14,13.91,0,0,0,0,0,0,0,0,0,0,0,0,0,2,2
Medio_bajo,No_siniestro,341911,5,5735.3,0,0,1,0,0,0,0,1,1,0,0,0,1,0,2
Medio_bajo,No_siniestro,407860,42,7329.94,0,0,0,1,0,0,0,1,0,0,0,1,1,0,2
Medio_bajo,No_siniestro,606292,6,1504.98,0,1,0,0,0,0,0,1,2,0,0,0,0,0,2
Medio_bajo,No_siniestro,616423,2,11725.34,0,0,0,0,0,0,0,0,0,0,0,0,0,2,2
Medio_bajo,No_siniestro,628219,2,0.37,0,0,0,0,0,0,0,0,0,0,0,0,0,2,2
Medio_bajo,No_siniestro,634776,13,977.14,0,0,0,0,0,0,0,0,0,0,0,0,1,1,2
Medio_bajo,No_siniestro,636803,57,705.61,0,0,0,0,0,0,1,1,0,0,0,0,1,1,2
Medio_bajo,No_siniestro,647435,28,13515.49,65597.84,0,1,1,0,0,0,2,1,1,0,0,0,0,2
Medio_bajo,No_siniestro,703538,0,2.43,0,0,0,0,0,0,0,0,1,1,0,0,0,0,2
Medio_bajo,No_siniestro,780459,35,743.6,0,0,1,0,0,0,0,1,0,1,1,0,0,0,2
Medio_alto,No_siniestro,38847,10,16021.13,34981.76,0,0,0,0,0,1,1,0,0,0,0,0,2,2
Medio_alto,Si_siniestro,74282,75,10354.47,0,1,1,1,1,1,2,7,0,0,0,0,1,1,2
Medio_alto,No_siniestro,88275,74,18656.27,0,0,0,0,0,0,1,1,0,0,0,2,0,0,2
Medio_alto,No_siniestro,89056,116,6784.91,0,0,0,1,1,0,1,3,0,0,0,2,0,0,2
Medio_alto,No_siniestro,128474,79,198.48,0,0,0,0,0,0,0,0,2,0,0,0,0,0,2
Medio_alto,No_siniestro,217101,18,10070.27,0,1,0,0,0,0,1,2,1,0,0,0,0,1,2
Medio_alto,No_siniestro,480528,178,25433.9,0,0,0,2,0,0,0,2,0,0,0,2,0,0,2
Medio_alto,No_siniestro,557438,29,24482.77,72509.17,0,0,0,0,0,0,0,0,0,0,0,1,1,2
Medio_alto,No_siniestro,624422,9,2232.13,69610.28,0,0,0,0,0,0,0,1,1,0,0,0,0,2
Medio,No_siniestro,176710,49,11642.79,0,0,0,0,0,0,0,0,0,0,0,0,1,1,2
Medio,Si_siniestro,376141,7,917.09,0,0,0,0,1,0,0,1,0,0,1,1,0,0,2
Medio,No_siniestro,442063,39,6447.94,0,0,0,0,0,0,0,0,1,1,0,0,0,0,2
Medio,No_siniestro,503641,8,2485.25,0,1,0,0,0,0,0,1,0,1,1,0,0,0,2
Medio,No_siniestro,686125,81,712.69,0,0,0,0,0,0,0,0,1,1,0,0,0,0,2
Medio,No_siniestro,693076,81,6874.25,0,0,0,0,0,0,0,0,1,1,0,0,0,0,2
Medio,No_siniestro,772265,58,6792.68,52758.18,0,0,0,0,0,0,0,0,0,0,0,1,1,2
Medio,No_siniestro,236394,15,2,0,0,0,0,0,0,0,0,0,0,0,0,1,1,2
Medio,No_siniestro,580212,4,601.73,0,0,0,0,0,0,0,0,0,0,1,1,0,0,2
Bajo,No_siniestro,10186,6,652.05,0,0,0,0,0,0,0,0,0,0,1,0,0,1,2
Bajo,No_siniestro,29768,42,858.26,0,0,0,0,0,0,0,0,2,0,0,0,0,0,2
Bajo,No_siniestro,34261,15,2482.71,0,0,0,0,0,0,0,0,0,1,1,0,0,0,2
Bajo,No_siniestro,49902,23,18.38,0,0,0,0,0,0,0,0,1,1,0,0,0,0,2
Bajo,No_siniestro,55134,24,226.18,0,1,0,1,0,1,1,4,1,0,1,0,0,0,2
Bajo,No_siniestro,62253,192,2540.46,0,1,1,1,1,1,1,6,1,0,0,0,0,1,2
Bajo,No_siniestro,84866,7,1255.17,0,0,0,1,0,1,0,2,0,0,1,0,1,0,2
Bajo,No_siniestro,141392,51,1145.65,0,1,1,0,0,0,0,2,1,1,0,0,0,0,2
Bajo,No_siniestro,148209,12,1793.26,0,0,0,0,0,0,0,0,1,0,1,0,0,0,2
Bajo,No_siniestro,184554,8,2157.89,0,0,0,0,0,0,0,0,1,0,0,0,0,1,2
Bajo,Si_siniestro,184705,12,2486.99,0,1,1,1,0,0,0,3,1,0,0,1,0,0,2
Bajo,No_siniestro,203486,91,37.01,0,0,0,0,0,0,0,0,1,1,0,0,0,0,2
Bajo,No_siniestro,205061,11,667.03,0,0,0,0,1,1,1,3,0,0,0,2,0,0,2
Bajo,Si_siniestro,210189,17,1928.94,0,2,2,1,1,0,0,6,1,1,0,0,0,0,2
Bajo,Si_siniestro,239510,49,1522.99,0,2,1,0,0,0,0,3,1,0,0,0,1,0,2
Bajo,No_siniestro,244595,11,2057.06,0,1,0,0,0,0,0,1,1,0,1,0,0,0,2
Bajo,Si_siniestro,247852,10,915.12,0,2,1,0,0,0,0,3,1,1,0,0,0,0,2
Bajo,No_siniestro,248071,7,445.21,0,0,0,0,0,0,0,0,1,0,0,0,1,0,2
Bajo,No_siniestro,280816,37,6379.34,0,0,0,0,0,0,1,1,1,0,0,1,0,0,2
Bajo,No_siniestro,290262,7,769.22,0,0,0,0,0,0,0,0,1,1,0,0,0,0,2
Bajo,Si_siniestro,304279,6,719.83,0,0,0,0,0,0,0,0,1,1,0,0,0,0,2
Bajo,No_siniestro,350460,44,6969.38,0,1,1,1,0,1,1,5,0,0,0,2,0,0,2
Bajo,No_siniestro,362457,30,699.26,0,1,0,0,1,0,0,2,1,0,0,1,0,0,2
Bajo,No_siniestro,374472,30,1580.7,0,0,0,0,0,0,1,1,0,0,1,0,0,1,2
Bajo,No_siniestro,376381,6,465.41,0,0,0,0,0,0,0,0,2,0,0,0,0,0,2
Bajo,No_siniestro,403315,147,1535.26,0,0,0,0,0,0,0,0,0,0,0,1,1,0,2
Bajo,No_siniestro,416566,88,4.17,0,0,0,0,0,1,0,1,0,1,0,0,1,0,2
Bajo,Si_siniestro,427315,17,6024.95,0,1,2,2,1,0,0,6,1,1,0,0,0,0,2
Bajo,Si_siniestro,434341,30,4813.98,0,0,0,0,0,0,0,0,0,1,1,0,0,0,2
Bajo,Si_siniestro,447655,6,1237.22,0,0,0,0,0,0,0,0,0,0,0,1,1,0,2
Bajo,No_siniestro,468361,26,1920.39,0,0,1,1,0,0,0,2,0,0,0,0,0,2,2
Bajo,Si_siniestro,480749,19,311.73,0,0,1,0,1,0,0,2,0,0,1,1,0,0,2
Bajo,No_siniestro,488252,20,3337.2,0,1,0,0,0,0,0,1,0,0,0,0,1,1,2
Bajo,No_siniestro,493280,40,93.28,0,0,0,0,0,0,0,0,0,0,1,0,1,0,2
Bajo,Si_siniestro,495712,7,1547.15,0,1,0,0,0,0,0,1,0,0,0,0,1,1,2
Bajo,No_siniestro,496377,7,2124.4,0,0,0,0,0,0,0,0,0,0,0,1,1,0,2
Bajo,No_siniestro,501201,23,1334.98,0,0,0,0,0,0,0,0,0,0,0,1,1,0,2
Bajo,Si_siniestro,513633,9,871.7,0,2,1,0,0,0,0,3,1,1,0,0,0,0,2
Bajo,No_siniestro,520072,11,567.2,0,0,0,0,0,1,1,2,0,0,0,0,1,1,2
Bajo,No_siniestro,545623,21,205.14,0,1,1,1,1,1,1,6,0,1,1,0,0,0,2
Bajo,No_siniestro,564825,11,1113.1,0,0,0,0,0,1,0,1,0,1,1,0,0,0,2
Bajo,Si_siniestro,576378,10,812.63,0,1,0,0,0,0,0,1,2,0,0,0,0,0,2
Bajo,No_siniestro,587179,64,559.2,0,0,0,0,0,1,1,2,0,0,1,1,0,0,2
Bajo,Si_siniestro,601618,31,2214.8,0,1,0,0,0,0,0,1,2,0,0,0,0,0,2
Bajo,No_siniestro,613750,40,380.56,0,0,0,0,1,1,1,3,0,0,1,1,0,0,2
Bajo,No_siniestro,615948,53,3746.67,0,0,0,0,0,0,0,0,0,1,1,0,0,0,2
Bajo,No_siniestro,622772,8,784.83,0,0,0,0,0,0,0,0,0,0,0,0,1,1,2
Bajo,No_siniestro,624893,29,902.46,0,0,0,0,0,0,0,0,0,0,0,0,1,1,2
Bajo,Si_siniestro,633329,11,1272.43,0,1,1,1,1,0,0,4,1,1,0,0,0,0,2
Bajo,No_siniestro,634379,9,691.28,0,0,0,0,0,0,0,0,2,0,0,0,0,0,2
Bajo,No_siniestro,636034,11,1035.17,0,0,0,1,1,0,1,3,0,0,1,1,0,0,2
Bajo,No_siniestro,652083,160,197.85,0,0,0,0,0,0,0,0,0,0,0,0,1,1,2
Bajo,No_siniestro,675340,43,312.16,0,0,0,0,0,0,0,0,1,1,0,0,0,0,2
Bajo,No_siniestro,685632,7,713.51,0,0,0,0,0,0,0,0,1,1,0,0,0,0,2
Bajo,No_siniestro,696892,54,5.64,0,0,0,0,0,0,0,0,0,0,0,0,0,2,2
Bajo,No_siniestro,712440,43,2154.37,0,0,0,0,0,0,0,0,1,1,0,0,0,0,2
Bajo,No_siniestro,728007,11,804.84,0,0,0,0,0,0,0,0,0,1,1,0,0,0,2
Bajo,Si_siniestro,752410,43,8376.63,0,0,1,0,0,1,0,2,0,1,1,0,0,0,2
Bajo,Si_siniestro,783011,14,505.44,0,0,0,2,1,0,0,3,1,0,0,1,0,0,2
Bajo,No_siniestro,787318,7,1015.41,0,1,1,0,0,0,0,2,0,0,0,0,1,1,2
Bajo,No_siniestro,52777,1,1083.33,0,0,0,0,0,0,0,0,0,0,1,1,0,0,2
Bajo,No_siniestro,57374,6,1815.61,0,0,0,0,0,0,0,0,1,0,0,1,0,0,2
Bajo,No_siniestro,72978,101,2341.96,0,0,2,1,1,0,0,4,0,1,1,0,0,0,2
Bajo,No_siniestro,173541,11,374.48,0,0,0,0,1,0,0,1,0,0,1,1,0,0,2
Bajo,No_siniestro,175566,0,2166.83,0,0,0,0,0,0,0,0,0,0,1,1,0,0,2
Bajo,No_siniestro,181336,9,38.99,0,0,0,0,0,0,0,0,1,1,0,0,0,0,2
Bajo,No_siniestro,236532,24,770.93,0,0,0,1,1,0,0,2,0,0,1,1,0,0,2
Bajo,No_siniestro,248367,4,1407.74,0,0,0,0,0,0,0,0,0,0,0,1,1,0,2
Bajo,No_siniestro,366836,55,0,0,0,0,0,0,0,0,0,0,0,0,1,1,0,2
Bajo,No_siniestro,373699,3,1182.33,0,1,1,0,0,0,0,2,0,2,0,0,0,0,2
Bajo,No_siniestro,424212,36,918.94,0,0,0,0,0,0,0,0,0,1,0,1,0,0,2
Bajo,No_siniestro,569006,17,156.72,0,1,1,0,0,1,1,4,0,0,0,1,1,0,2
Bajo,No_siniestro,572144,4,404.23,0,0,0,0,0,0,0,0,2,0,0,0,0,0,2
Bajo,No_siniestro,581121,18,325.92,0,1,1,1,0,0,0,3,1,0,0,1,0,0,2
Bajo,No_siniestro,619379,7,1852.2,0,0,0,0,0,0,0,0,0,1,0,0,0,1,2
Bajo,No_siniestro,637042,8,0,0,0,0,0,0,0,0,0,1,1,0,0,0,0,2
Bajo,No_siniestro,691171,5,3521.03,0,0,1,0,0,0,0,1,1,1,0,0,0,0,2
Bajo,No_siniestro,691947,4,879.77,0,0,0,0,0,0,0,0,1,1,0,0,0,0,2
Bajo,No_siniestro,715993,4,1502.77,0,1,1,0,0,0,0,2,1,1,0,0,0,0,2
Bajo,No_siniestro,716638,34,3881.02,0,0,0,0,0,0,0,0,1,1,0,0,0,0,2
Moderado,No_siniestro,147957,42,26350.24,0,0,0,0,0,0,0,0,0,0,0,0,0,1,1
Moderado,No_siniestro,196480,49,17507.11,29732.22,0,0,0,0,0,0,0,0,0,0,0,0,1,1
Moderado,No_siniestro,210990,49,8123.88,0,0,0,0,1,0,0,1,0,1,0,0,0,0,1
Moderado,No_siniestro,276341,60,13943,0,0,0,0,1,0,0,1,0,0,0,0,0,1,1
Moderado,No_siniestro,283678,98,28056.3,180427.98,0,0,0,1,1,0,2,0,0,0,0,1,0,1
Moderado,No_siniestro,325071,127,491.32,0,0,0,0,0,0,0,0,1,0,0,0,0,0,1
Moderado,No_siniestro,345690,44,47230.82,48538.79,0,0,0,1,0,0,1,0,0,0,1,0,0,1
Moderado,No_siniestro,347725,47,6174.86,0,0,0,0,0,0,0,0,0,0,1,0,0,0,1
Moderado,No_siniestro,478473,162,1928.58,0,0,0,0,0,0,0,0,0,0,0,1,0,0,1
Moderado,No_siniestro,662169,126,559.34,0,0,0,0,0,0,0,0,0,0,1,0,0,0,1
Moderado,No_siniestro,324952,93,25035.16,0,0,0,0,0,1,0,1,0,0,0,0,1,0,1
Moderado,No_siniestro,426721,33,2694.94,0,0,0,0,1,1,0,2,0,0,1,0,0,0,1
Medio_bajo,Si_siniestro,31907,20,2015.41,0,0,1,1,0,1,1,4,0,0,1,0,0,0,1
Medio_bajo,Si_siniestro,36031,36,2099.65,0,1,1,0,0,0,0,2,1,0,0,0,0,0,1
Medio_bajo,No_siniestro,45146,52,1596.62,0,0,1,0,0,0,0,1,0,0,0,1,0,0,1
Medio_bajo,No_siniestro,45543,83,3785.68,0,0,0,0,0,0,0,0,0,0,1,0,0,0,1
Medio_bajo,Si_siniestro,46197,45,954.68,0,0,0,0,0,0,1,1,0,0,0,0,1,0,1
Medio_bajo,No_siniestro,46400,39,11.33,0,0,0,0,0,0,0,0,0,0,1,0,0,0,1
Medio_bajo,No_siniestro,64296,55,22.7,0,0,0,1,0,0,0,1,0,0,0,1,0,0,1
Medio_bajo,No_siniestro,68090,39,1905.85,0,0,0,0,0,0,0,0,0,0,1,0,0,0,1
Medio_bajo,No_siniestro,88489,13,2385.01,0,0,0,0,0,0,0,0,0,1,0,0,0,0,1
Medio_bajo,No_siniestro,99541,49,1592.58,0,0,0,0,0,0,0,0,0,0,0,0,0,1,1
Medio_bajo,No_siniestro,102006,17,917.26,0,0,0,0,0,0,0,0,0,1,0,0,0,0,1
Medio_bajo,No_siniestro,112023,30,9204.5,0,0,0,0,0,0,0,0,0,0,0,0,1,0,1
Medio_bajo,No_siniestro,115595,14,696.99,0,0,1,0,1,0,0,2,0,1,0,0,0,0,1
Medio_bajo,No_siniestro,115753,8,2422.81,0,1,0,0,0,0,0,1,1,0,0,0,0,0,1
Medio_bajo,No_siniestro,125878,88,3482.05,0,0,0,0,0,0,0,0,0,0,0,0,1,0,1
Medio_bajo,No_siniestro,127939,94,2157.91,0,0,0,0,1,0,0,1,0,0,0,0,0,1,1
Medio_bajo,No_siniestro,133407,11,1226.89,0,0,0,0,0,0,0,0,1,0,0,0,0,0,1
Medio_bajo,No_siniestro,151577,58,17190.66,0,0,0,0,0,0,0,0,0,0,0,1,0,0,1
Medio_bajo,Si_siniestro,152336,12,939.08,0,1,1,1,1,1,1,6,0,0,0,0,1,0,1
Medio_bajo,No_siniestro,152484,21,5469.13,0,0,0,0,0,0,0,0,0,0,0,0,1,0,1
Medio_bajo,Si_siniestro,161616,58,7513.55,0,1,1,0,1,1,0,4,1,0,0,0,0,0,1
Medio_bajo,No_siniestro,162461,34,6098.19,0,1,0,1,0,1,1,4,0,0,0,1,0,0,1
Medio_bajo,No_siniestro,202712,96,2742.24,0,0,0,0,0,0,0,0,0,0,0,0,1,0,1
Medio_bajo,Si_siniestro,215261,161,5434.33,0,1,1,0,0,0,0,2,0,0,0,1,0,0,1
Medio_bajo,No_siniestro,215692,9,10199.78,0,0,0,0,0,1,0,1,1,0,0,0,0,0,1
Medio_bajo,No_siniestro,225603,24,2446.82,0,0,0,0,0,0,0,0,1,0,0,0,0,0,1
Medio_bajo,No_siniestro,226920,49,3698.07,0,1,0,0,0,0,0,1,0,0,1,0,0,0,1
Medio_bajo,No_siniestro,237996,54,2939.43,0,0,0,0,0,0,0,0,1,0,0,0,0,0,1
Medio_bajo,No_siniestro,242903,6,1785.99,0,0,0,0,0,0,0,0,0,0,0,0,1,0,1
Medio_bajo,No_siniestro,261458,97,18739.1,24108.71,0,0,0,0,0,0,0,1,0,0,0,0,0,1
Medio_bajo,No_siniestro,264282,78,226.18,0,0,0,0,0,0,0,0,1,0,0,0,0,0,1
Medio_bajo,No_siniestro,268217,13,3931.77,0,0,0,0,0,0,0,0,0,1,0,0,0,0,1
Medio_bajo,No_siniestro,272033,28,2002.43,0,0,0,0,0,1,0,1,0,0,0,0,1,0,1
Medio_bajo,No_siniestro,275860,49,8213.4,0,0,0,0,0,0,0,0,0,0,0,0,0,1,1
Medio_bajo,No_siniestro,277179,35,2080.37,0,0,0,0,0,0,0,0,0,0,1,0,0,0,1
Medio_bajo,No_siniestro,294147,50,962.08,0,0,0,1,0,0,0,1,0,0,1,0,0,0,1
Medio_bajo,No_siniestro,302940,49,4680.24,0,0,0,0,0,0,0,0,1,0,0,0,0,0,1
Medio_bajo,No_siniestro,306626,122,1743,0,0,0,0,0,1,0,1,0,0,0,0,1,0,1
Medio_bajo,No_siniestro,306886,28,11367.68,0,0,1,0,0,0,0,1,0,0,0,1,0,0,1
Medio_bajo,No_siniestro,318267,138,12578.65,0,0,0,0,0,0,0,0,0,1,0,0,0,0,1
Medio_bajo,No_siniestro,335446,32,875.62,0,0,0,0,0,0,0,0,0,0,0,1,0,0,1
Medio_bajo,No_siniestro,341132,49,2099.11,0,0,0,0,0,0,0,0,0,1,0,0,0,0,1
Medio_bajo,Si_siniestro,341477,62,6510,0,1,2,1,0,0,0,4,0,1,0,0,0,0,1
Medio_bajo,No_siniestro,342568,55,1542.49,0,0,0,0,0,0,0,0,0,1,0,0,0,0,1
Medio_bajo,No_siniestro,343555,15,5974.29,0,0,0,0,0,0,0,0,0,1,0,0,0,0,1
Medio_bajo,Si_siniestro,350673,10,1204.09,0,0,1,0,0,0,0,1,1,0,0,0,0,0,1
Medio_bajo,No_siniestro,351133,105,2982.5,0,0,0,0,0,1,0,1,0,0,0,0,0,1,1
Medio_bajo,No_siniestro,359424,58,195.6,0,0,0,0,0,0,0,0,0,0,0,0,1,0,1
Medio_bajo,Si_siniestro,368026,74,83.36,0,3,2,1,0,1,0,7,0,0,0,0,0,1,1
Medio_bajo,No_siniestro,390776,46,2210.11,0,0,0,0,0,0,0,0,0,1,0,0,0,0,1
Medio_bajo,No_siniestro,394277,154,6245.97,0,0,0,0,0,1,0,1,0,0,0,0,1,0,1
Medio_bajo,No_siniestro,397842,63,2543.17,0,0,0,0,0,0,0,0,0,0,0,0,1,0,1
Medio_bajo,No_siniestro,413198,120,334.85,0,0,1,1,0,0,0,2,1,0,0,0,0,0,1
Medio_bajo,No_siniestro,415097,97,4030.92,0,0,0,0,0,0,0,0,0,0,0,1,0,0,1
Medio_bajo,No_siniestro,415297,125,402.93,0,1,0,0,2,1,0,4,0,0,0,1,0,0,1
Medio_bajo,No_siniestro,415877,26,9006.44,0,0,3,2,0,0,1,6,0,0,0,0,0,1,1
Medio_bajo,No_siniestro,423114,7,3137.86,0,0,1,0,0,0,0,1,1,0,0,0,0,0,1
Medio_bajo,No_siniestro,423130,44,253.89,0,0,0,0,0,0,0,0,0,0,0,0,0,1,1
Medio_bajo,No_siniestro,424779,120,1112.36,0,0,0,0,0,0,1,1,0,0,0,0,0,1,1
Medio_bajo,No_siniestro,425712,90,1687.76,0,0,0,0,1,0,0,1,0,0,1,0,0,0,1
Medio_bajo,No_siniestro,446906,6,452.9,0,0,0,0,0,0,0,0,0,0,0,1,0,0,1
Medio_bajo,No_siniestro,458562,54,624.55,0,0,0,0,0,0,0,0,0,0,0,1,0,0,1
Medio_bajo,No_siniestro,463940,44,113.31,0,0,0,0,0,0,0,0,0,0,0,1,0,0,1
Medio_bajo,No_siniestro,475749,80,647.05,0,0,0,0,0,0,0,0,0,0,0,1,0,0,1
Medio_bajo,No_siniestro,485319,67,2069.28,0,0,0,0,0,0,0,0,0,0,1,0,0,0,1
Medio_bajo,No_siniestro,507613,21,4294.79,0,0,0,0,0,0,0,0,0,0,0,0,1,0,1
Medio_bajo,No_siniestro,517039,25,45.73,0,0,0,0,0,0,1,1,0,0,0,0,0,1,1
Medio_bajo,Si_siniestro,526075,24,10979.7,0,0,0,0,0,0,0,0,1,0,0,0,0,0,1
Medio_bajo,No_siniestro,537408,70,7976.67,0,0,0,0,0,0,0,0,1,0,0,0,0,0,1
Medio_bajo,No_siniestro,537781,18,8683.77,39568.68,2,1,1,0,0,0,4,1,0,0,0,0,0,1
Medio_bajo,Si_siniestro,539172,27,1469.16,0,1,0,0,0,0,0,1,1,0,0,0,0,0,1
Medio_bajo,No_siniestro,541393,33,1317.64,0,0,0,0,0,0,0,0,0,0,0,0,0,1,1
Medio_bajo,No_siniestro,550022,58,1609.94,0,0,0,0,0,0,0,0,0,0,0,0,0,1,1
Medio_bajo,No_siniestro,555830,40,10277.46,29398.15,0,0,0,0,0,0,0,0,0,0,1,0,0,1
Medio_bajo,No_siniestro,558977,12,14574.97,0,0,0,0,0,0,0,0,0,0,0,0,1,0,1
Medio_bajo,No_siniestro,563677,10,2608.13,0,0,0,0,0,0,0,0,0,0,0,0,0,1,1
Medio_bajo,Si_siniestro,564575,76,8151.15,53137.18,0,0,0,0,0,0,0,1,0,0,0,0,0,1
Medio_bajo,No_siniestro,572382,47,484.42,0,0,0,0,0,0,0,0,0,0,0,0,0,1,1
Medio_bajo,No_siniestro,579482,43,8182.18,55681.19,0,0,0,0,1,1,2,0,0,0,1,0,0,1
Medio_bajo,No_siniestro,603506,12,4872.24,0,0,0,0,0,0,0,0,1,0,0,0,0,0,1
Medio_bajo,No_siniestro,603787,160,5892.57,0,0,0,0,0,0,1,1,1,0,0,0,0,0,1
Medio_bajo,No_siniestro,616760,40,313.72,0,0,0,0,0,0,0,0,1,0,0,0,0,0,1
Medio_bajo,No_siniestro,622586,19,18161.7,0,0,0,0,0,0,0,0,0,0,0,0,1,0,1
Medio_bajo,No_siniestro,623482,104,12431.07,0,1,0,0,0,0,0,1,1,0,0,0,0,0,1
Medio_bajo,No_siniestro,629350,40,996.32,57918.24,0,0,0,0,0,0,0,0,0,0,0,0,1,1
Medio_bajo,No_siniestro,634028,24,204.55,0,0,0,0,0,0,0,0,1,0,0,0,0,0,1
Medio_bajo,No_siniestro,649247,12,1702.56,0,0,0,0,0,0,0,0,1,0,0,0,0,0,1
Medio_bajo,No_siniestro,656276,88,124102.08,128892.33,0,0,0,2,1,0,3,0,0,1,0,0,0,1
Medio_bajo,No_siniestro,667429,50,576.34,0,0,0,0,0,0,0,0,0,0,0,0,0,1,1
Medio_bajo,No_siniestro,695599,116,3586.26,0,0,0,0,0,0,0,0,0,0,1,0,0,0,1
Medio_bajo,No_siniestro,699723,24,2000.82,0,0,0,0,0,0,0,0,0,0,1,0,0,0,1
Medio_bajo,No_siniestro,706398,29,942.2,0,0,1,0,0,0,0,1,0,0,1,0,0,0,1
Medio_bajo,No_siniestro,716286,7,381.15,0,0,0,2,1,2,1,6,0,0,1,0,0,0,1
Medio_bajo,No_siniestro,722134,59,15076.46,0,0,0,0,0,0,0,0,0,0,0,1,0,0,1
Medio_bajo,No_siniestro,745988,41,13234.19,0,0,0,0,0,0,0,0,1,0,0,0,0,0,1
Medio_bajo,No_siniestro,759281,11,2883.21,0,0,0,0,0,0,0,0,1,0,0,0,0,0,1
Medio_bajo,No_siniestro,45180,42,1094.76,0,0,0,0,0,0,0,0,0,0,0,0,0,1,1
Medio_bajo,No_siniestro,104309,46,1080.37,0,0,0,0,0,0,0,0,0,0,0,0,1,0,1
Medio_bajo,No_siniestro,151147,3,4079.16,0,0,0,0,0,0,0,0,1,0,0,0,0,0,1
Medio_bajo,No_siniestro,188716,0,426.27,0,0,0,0,0,0,0,0,0,0,0,0,0,1,1
Medio_bajo,No_siniestro,197065,17,661.43,0,0,0,0,0,0,0,0,0,0,0,0,0,1,1
Medio_bajo,No_siniestro,232307,7,462.57,0,0,0,0,0,0,0,0,0,0,0,0,0,1,1
Medio_bajo,No_siniestro,266927,0,831.8,0,0,0,0,0,0,0,0,1,0,0,0,0,0,1
Medio_bajo,No_siniestro,268193,44,3048.15,0,1,0,0,0,0,0,1,1,0,0,0,0,0,1
Medio_bajo,No_siniestro,449063,51,10949.15,0,0,1,2,1,0,0,4,1,0,0,0,0,0,1
Medio_bajo,No_siniestro,466209,86,0,0,0,0,0,0,0,0,0,0,0,0,1,0,0,1
Medio_bajo,No_siniestro,497270,42,633.52,0,0,1,0,1,0,0,2,0,0,0,1,0,0,1
Medio_bajo,No_siniestro,547290,42,0,0,0,0,0,0,0,0,0,0,0,0,0,1,0,1
Medio_bajo,No_siniestro,564089,5,3777.51,0,0,0,0,0,0,0,0,1,0,0,0,0,0,1
Medio_bajo,No_siniestro,601756,5,1659.7,0,0,0,0,0,0,0,0,1,0,0,0,0,0,1
Medio_bajo,No_siniestro,602253,45,4191.54,0,0,0,0,0,0,1,1,0,0,1,0,0,0,1
Medio_bajo,No_siniestro,741081,26,0,0,0,0,0,0,0,0,0,0,0,0,1,0,0,1
Medio_bajo,No_siniestro,759253,2,217.12,0,0,0,0,0,0,0,0,0,0,0,0,0,1,1
Medio_bajo,No_siniestro,765955,8,706.71,9540.16,0,0,0,0,0,0,0,1,0,0,0,0,0,1
Medio_alto,No_siniestro,19264,42,10033.09,0,0,0,1,1,2,1,5,0,0,0,0,1,0,1
Medio_alto,Si_siniestro,45194,13,9489.19,0,0,0,0,0,0,0,0,0,0,0,0,1,0,1
Medio_alto,No_siniestro,67989,55,1139,0,0,0,0,0,0,0,0,0,0,0,0,0,1,1
Medio_alto,No_siniestro,77758,216,3935.81,0,0,0,0,0,0,1,1,0,0,1,0,0,0,1
Medio_alto,No_siniestro,105081,143,11567.04,69092.1,0,0,0,1,0,0,1,0,0,0,0,0,1,1
Medio_alto,No_siniestro,151221,168,41643.16,0,0,0,0,0,0,0,0,0,1,0,0,0,0,1
Medio_alto,No_siniestro,200547,88,888.71,0,0,0,0,0,0,0,0,0,1,0,0,0,0,1
Medio_alto,No_siniestro,214780,49,13520.39,0,0,0,0,0,0,0,0,0,0,1,0,0,0,1
Medio_alto,No_siniestro,266520,49,34348.56,84842.37,0,0,0,0,0,0,0,0,0,0,1,0,0,1
Medio_alto,Si_siniestro,316496,49,10499.49,0,0,0,0,0,0,0,0,1,0,0,0,0,0,1
Medio_alto,No_siniestro,333271,42,17336.6,0,0,0,0,0,0,0,0,0,1,0,0,0,0,1
Medio_alto,No_siniestro,355197,23,12639.83,0,0,0,0,0,0,0,0,1,0,0,0,0,0,1
Medio_alto,No_siniestro,743291,27,2659.21,0,0,0,0,0,0,0,0,1,0,0,0,0,0,1
Medio_alto,No_siniestro,753695,139,9110.72,0,0,0,0,0,0,0,0,0,0,0,0,0,1,1
Medio_alto,No_siniestro,677328,58,4610.59,0,0,0,0,0,0,0,0,0,0,1,0,0,0,1
Medio,No_siniestro,118324,23,3602.23,0,0,0,0,0,0,0,0,1,0,0,0,0,0,1
Medio,Si_siniestro,124442,7,872.75,0,0,0,0,1,0,0,1,0,0,1,0,0,0,1
Medio,No_siniestro,182898,14,4031.47,0,0,0,0,0,0,0,0,0,0,0,0,0,1,1
Medio,No_siniestro,187109,17,814.89,0,0,0,0,0,0,0,0,0,0,0,0,0,1,1
Medio,No_siniestro,238954,72,6531.94,0,0,0,0,0,1,0,1,0,1,0,0,0,0,1
Medio,Si_siniestro,248963,12,3899.43,0,0,0,0,0,0,0,0,0,0,0,1,0,0,1
Medio,No_siniestro,304850,49,3825.1,0,0,0,0,0,0,0,0,0,0,0,0,1,0,1
Medio,No_siniestro,306157,48,997.82,0,0,0,0,0,0,1,1,0,1,0,0,0,0,1
Medio,No_siniestro,307378,44,2690.6,0,1,0,0,0,0,0,1,0,1,0,0,0,0,1
Medio,Si_siniestro,312497,14,789.23,0,0,0,1,0,1,0,2,1,0,0,0,0,0,1
Medio,No_siniestro,503927,18,41.04,0,0,0,0,0,0,0,0,0,0,0,0,0,1,1
Medio,No_siniestro,504598,47,16257.26,0,0,0,0,0,1,0,1,0,0,0,0,1,0,1
Medio,No_siniestro,509504,9,6657.33,0,2,1,1,1,0,1,6,1,0,0,0,0,0,1
Medio,No_siniestro,568392,17,8232.45,0,1,1,1,0,0,0,3,1,0,0,0,0,0,1
Medio,Si_siniestro,575201,7,1020.88,0,1,0,0,0,0,0,1,1,0,0,0,0,0,1
Medio,No_siniestro,714362,18,14698.34,0,0,0,0,0,0,0,0,0,0,0,0,0,1,1
Medio,No_siniestro,113980,42,7375.81,0,0,0,0,1,0,0,1,0,1,0,0,0,0,1
Medio,No_siniestro,122382,7,2925.6,0,0,0,0,0,0,0,0,1,0,0,0,0,0,1
Medio,No_siniestro,174352,0,7.82,0,0,0,0,0,0,0,0,0,0,1,0,0,0,1
Medio,No_siniestro,230893,5,1850.95,0,2,1,1,1,0,0,5,1,0,0,0,0,0,1
Bajo,No_siniestro,10319,43,877.58,0,0,1,0,0,1,1,3,0,0,1,0,0,0,1
Bajo,Si_siniestro,34799,6,2632,0,1,0,0,0,0,0,1,1,0,0,0,0,0,1
Bajo,No_siniestro,46674,17,399.01,0,0,0,0,0,0,0,0,1,0,0,0,0,0,1
Bajo,Si_siniestro,47878,11,4491.6,0,0,0,0,0,1,0,1,0,0,0,0,0,1,1
Bajo,No_siniestro,49437,14,1698.55,0,0,0,0,0,0,0,0,0,1,0,0,0,0,1
Bajo,No_siniestro,54145,12,767.82,0,1,0,1,0,0,0,2,1,0,0,0,0,0,1
Bajo,Si_siniestro,55660,39,890.79,0,0,1,1,1,0,1,4,0,0,1,0,0,0,1
Bajo,No_siniestro,66752,86,271.83,0,0,0,0,0,0,0,0,1,0,0,0,0,0,1
Bajo,No_siniestro,68704,103,30.01,0,0,0,0,0,0,0,0,0,0,0,1,0,0,1
Bajo,No_siniestro,70927,24,925.84,0,0,0,0,0,0,0,0,0,0,0,0,0,1,1
Bajo,No_siniestro,76959,8,862.27,0,0,0,0,0,0,0,0,1,0,0,0,0,0,1
Bajo,No_siniestro,83617,19,460.78,0,0,0,0,0,0,0,0,0,0,0,0,0,1,1
Bajo,No_siniestro,96473,45,1132.09,0,0,0,0,0,0,1,1,0,0,0,0,0,1,1
Bajo,No_siniestro,102679,60,1546.73,0,0,0,0,0,0,0,0,1,0,0,0,0,0,1
Bajo,No_siniestro,105767,38,687.83,0,0,0,0,0,0,0,0,0,0,0,1,0,0,1
Bajo,No_siniestro,108270,39,635.87,0,0,0,0,0,0,0,0,0,0,0,0,1,0,1
Bajo,No_siniestro,108547,27,1770.95,0,1,1,0,0,1,0,3,0,0,0,0,1,0,1
Bajo,Si_siniestro,112494,22,1367.38,0,2,1,1,1,1,1,7,1,0,0,0,0,0,1
Bajo,No_siniestro,125694,13,892.57,0,0,0,0,0,0,0,0,0,0,0,0,0,1,1
Bajo,No_siniestro,135212,61,516.82,0,1,0,0,0,0,0,1,1,0,0,0,0,0,1
Bajo,No_siniestro,159480,39,1192.09,0,0,0,0,0,0,0,0,0,1,0,0,0,0,1
Bajo,No_siniestro,168822,11,1164.35,0,0,0,0,0,0,0,0,0,0,1,0,0,0,1
Bajo,Si_siniestro,173687,30,433.11,0,0,0,0,0,0,0,0,0,0,0,0,1,0,1
Bajo,Si_siniestro,184521,22,274.94,0,0,0,0,0,2,1,3,1,0,0,0,0,0,1
Bajo,No_siniestro,188191,104,1426.09,0,0,0,0,0,0,0,0,1,0,0,0,0,0,1
Bajo,No_siniestro,199990,49,636.84,0,0,0,0,0,0,0,0,0,1,0,0,0,0,1
Bajo,No_siniestro,225096,32,914.94,0,0,0,0,0,0,0,0,0,0,1,0,0,0,1
Bajo,No_siniestro,228628,14,3093,0,0,0,0,0,0,0,0,0,0,0,0,1,0,1
Bajo,No_siniestro,230844,13,143.96,0,1,0,0,0,0,0,1,1,0,0,0,0,0,1
Bajo,No_siniestro,231774,16,460.9,0,1,1,1,0,1,1,5,0,0,1,0,0,0,1
Bajo,No_siniestro,234112,17,828.08,0,0,0,0,0,0,0,0,1,0,0,0,0,0,1
Bajo,No_siniestro,235826,60,1015.28,0,0,0,0,0,0,0,0,1,0,0,0,0,0,1
Bajo,Si_siniestro,243471,8,1746.42,0,0,0,0,0,0,0,0,1,0,0,0,0,0,1
Bajo,No_siniestro,244744,41,5838.08,0,0,0,0,1,1,0,2,0,0,0,1,0,0,1
Bajo,Si_siniestro,247269,7,1202.43,0,0,0,0,0,0,0,0,1,0,0,0,0,0,1
Bajo,Si_siniestro,249157,25,1244.69,0,0,0,1,0,0,0,1,0,0,1,0,0,0,1
Bajo,Si_siniestro,251068,9,1866.19,0,1,0,0,0,0,0,1,0,0,1,0,0,0,1
Bajo,No_siniestro,281088,15,248.65,0,0,0,0,0,0,0,0,0,0,0,0,1,0,1
Bajo,No_siniestro,289052,35,646.87,0,0,0,0,0,0,0,0,0,0,1,0,0,0,1
Bajo,No_siniestro,291800,49,955.35,0,1,1,1,1,0,0,4,1,0,0,0,0,0,1
Bajo,Si_siniestro,295388,20,1922.18,0,0,0,0,0,0,1,1,0,1,0,0,0,0,1
Bajo,No_siniestro,297719,140,4704.43,0,1,0,0,0,0,0,1,0,0,1,0,0,0,1
Bajo,No_siniestro,325325,10,104.77,0,0,0,0,0,0,0,0,1,0,0,0,0,0,1
Bajo,No_siniestro,350822,22,1105.8,0,0,0,0,1,0,0,1,0,0,0,1,0,0,1
Bajo,Si_siniestro,361925,6,2135.12,0,0,1,1,1,1,0,4,1,0,0,0,0,0,1
Bajo,No_siniestro,362368,7,287.15,0,0,0,0,0,0,0,0,1,0,0,0,0,0,1
Bajo,No_siniestro,363972,26,1223.82,0,0,0,0,0,0,0,0,0,1,0,0,0,0,1
Bajo,Si_siniestro,370932,29,2064.83,0,0,0,0,1,0,0,1,0,0,0,1,0,0,1
Bajo,Si_siniestro,372437,54,5142.46,0,0,0,0,0,0,0,0,0,0,1,0,0,0,1
Bajo,No_siniestro,374367,50,2108.57,0,0,0,0,0,0,0,0,0,1,0,0,0,0,1
Bajo,No_siniestro,384410,44,344.14,0,0,0,0,0,0,0,0,0,0,0,0,1,0,1
Bajo,No_siniestro,385382,11,843.34,0,0,0,0,0,0,0,0,1,0,0,0,0,0,1
Bajo,No_siniestro,402000,44,693.32,0,0,1,0,0,0,0,1,0,0,0,0,1,0,1
Bajo,Si_siniestro,431422,14,2556.64,0,0,0,0,0,0,1,1,0,0,0,0,0,1,1
Bajo,No_siniestro,432991,135,884.46,0,0,0,2,1,0,0,3,0,0,1,0,0,0,1
Bajo,No_siniestro,433772,7,364.15,0,1,1,1,0,1,0,4,1,0,0,0,0,0,1
Bajo,No_siniestro,434881,9,642.75,0,0,0,0,0,0,0,0,0,1,0,0,0,0,1
Bajo,No_siniestro,437841,14,423.55,0,0,1,0,0,0,0,1,1,0,0,0,0,0,1
Bajo,Si_siniestro,438759,13,3483.12,0,1,0,1,0,0,0,2,0,0,1,0,0,0,1
Bajo,Si_siniestro,447054,8,1298.72,0,2,1,0,0,0,0,3,1,0,0,0,0,0,1
Bajo,No_siniestro,475291,6,3052.08,0,0,0,0,0,0,0,0,0,0,1,0,0,0,1
Bajo,No_siniestro,478134,10,1544.42,0,0,0,1,0,0,0,1,0,0,0,0,0,1,1
Bajo,No_siniestro,480435,27,672.6,0,0,0,0,0,0,0,0,0,0,0,0,1,0,1
Bajo,No_siniestro,493599,44,331.13,0,0,0,1,0,0,0,1,0,0,0,1,0,0,1
Bajo,Si_siniestro,497299,30,1758.82,0,0,1,0,1,0,0,2,0,0,0,1,0,0,1
Bajo,No_siniestro,500124,7,465.23,0,1,1,1,1,1,1,6,0,0,1,0,0,0,1
Bajo,Si_siniestro,506175,14,1344.3,0,2,1,0,1,0,0,4,0,0,0,1,0,0,1
Bajo,Si_siniestro,513579,9,752.99,0,1,1,1,1,1,0,5,1,0,0,0,0,0,1
Bajo,No_siniestro,518127,27,736.7,0,0,0,0,0,0,0,0,0,0,0,1,0,0,1
Bajo,No_siniestro,519734,43,209.01,0,0,0,0,0,1,0,1,0,0,0,0,1,0,1
Bajo,Si_siniestro,542629,6,2875.6,0,2,1,1,1,0,0,5,1,0,0,0,0,0,1
Bajo,No_siniestro,544918,38,3415.68,0,0,0,0,0,0,0,0,1,0,0,0,0,0,1
Bajo,No_siniestro,564769,8,615.38,0,0,0,0,0,1,0,1,0,1,0,0,0,0,1
Bajo,No_siniestro,570721,29,923.96,0,0,0,0,0,0,0,0,0,0,0,0,1,0,1
Bajo,No_siniestro,572486,9,5279.77,0,0,1,0,0,0,0,1,0,1,0,0,0,0,1
Bajo,Si_siniestro,579458,25,728.95,0,1,1,0,0,0,0,2,1,0,0,0,0,0,1
Bajo,Si_siniestro,612293,8,501.18,0,1,0,0,0,0,0,1,1,0,0,0,0,0,1
Bajo,No_siniestro,621832,52,38.32,0,0,0,0,0,0,0,0,1,0,0,0,0,0,1
Bajo,No_siniestro,631897,9,565.7,0,0,0,0,0,0,0,0,0,1,0,0,0,0,1
Bajo,No_siniestro,641678,9,1584.92,0,0,0,0,0,0,0,0,1,0,0,0,0,0,1
Bajo,No_siniestro,648053,40,741.33,0,0,0,0,0,0,0,0,1,0,0,0,0,0,1
Bajo,No_siniestro,672672,99,793.41,0,0,0,0,0,0,0,0,0,0,1,0,0,0,1
Bajo,No_siniestro,679830,43,1372.65,0,0,1,0,0,0,0,1,0,0,1,0,0,0,1
Bajo,No_siniestro,688181,13,526.3,0,0,0,0,0,0,0,0,0,0,1,0,0,0,1
Bajo,Si_siniestro,714016,12,958.74,0,1,1,1,1,0,0,4,0,0,1,0,0,0,1
Bajo,No_siniestro,717704,19,426.35,0,0,0,0,0,0,0,0,0,0,1,0,0,0,1
Bajo,Si_siniestro,749828,8,2840.59,0,2,1,0,0,0,0,3,1,0,0,0,0,0,1
Bajo,Si_siniestro,790771,6,849.97,0,2,1,0,0,0,0,3,1,0,0,0,0,0,1
Bajo,No_siniestro,77029,8,1453.3,0,0,0,0,0,0,0,0,0,0,0,1,0,0,1
Bajo,No_siniestro,82507,6,1718.76,0,0,0,0,0,0,0,0,0,0,1,0,0,0,1
Bajo,No_siniestro,100274,0,2563,0,0,0,0,0,0,0,0,0,0,0,1,0,0,1
Bajo,No_siniestro,105355,20,0,0,0,0,0,0,0,0,0,0,0,0,0,0,1,1
Bajo,No_siniestro,111176,12,1764.89,0,0,1,0,0,0,0,1,0,1,0,0,0,0,1
Bajo,No_siniestro,118770,42,942.28,0,1,0,0,1,0,0,2,1,0,0,0,0,0,1
Bajo,No_siniestro,177554,12,0,0,0,0,0,1,0,0,1,0,0,1,0,0,0,1
Bajo,No_siniestro,184561,5,340.08,0,0,0,0,0,0,0,0,1,0,0,0,0,0,1
Bajo,No_siniestro,184821,1,409.24,0,0,0,0,0,0,0,0,0,0,0,0,0,1,1
Bajo,No_siniestro,196827,3,2091.69,0,0,0,0,0,0,0,0,0,0,0,0,0,1,1
Bajo,No_siniestro,199096,5,2226.26,0,0,1,0,0,0,0,1,0,1,0,0,0,0,1
Bajo,No_siniestro,249466,0,1366.21,0,0,0,0,0,0,0,0,0,0,1,0,0,0,1
Bajo,No_siniestro,257978,15,0,0,0,0,0,0,0,0,0,0,0,0,1,0,0,1
Bajo,No_siniestro,282146,1,456.3,0,0,0,0,0,0,0,0,0,0,0,0,1,0,1
Bajo,No_siniestro,294519,2,1135.55,0,1,0,0,0,0,0,1,0,0,0,0,0,1,1
Bajo,No_siniestro,296412,24,0,0,0,0,0,0,0,0,0,0,0,0,1,0,0,1
Bajo,No_siniestro,309769,2,127.86,0,0,0,0,0,0,0,0,0,1,0,0,0,0,1
Bajo,No_siniestro,352375,38,634.53,0,0,0,1,0,0,0,1,0,0,1,0,0,0,1
Bajo,No_siniestro,359593,5,364.47,0,0,0,0,0,0,0,0,1,0,0,0,0,0,1
Bajo,No_siniestro,361565,2,1675.72,0,0,0,0,0,0,0,0,0,1,0,0,0,0,1
Bajo,No_siniestro,380880,42,1324.39,0,0,0,0,0,0,0,0,0,0,0,0,1,0,1
Bajo,No_siniestro,434075,3,2052.5,0,0,0,0,0,0,0,0,0,0,0,1,0,0,1
Bajo,No_siniestro,446456,1,0,0,0,0,0,0,0,0,0,0,0,0,0,1,0,1
Bajo,No_siniestro,473710,42,4501.86,0,1,1,0,0,0,0,2,1,0,0,0,0,0,1
Bajo,No_siniestro,506935,14,2377.7,0,0,0,0,2,1,0,3,0,0,0,1,0,0,1
Bajo,No_siniestro,532459,44,67.87,0,4,3,2,1,1,0,11,1,0,0,0,0,0,1
Bajo,No_siniestro,594963,5,707.8,0,1,1,0,0,0,0,2,1,0,0,0,0,0,1
Bajo,No_siniestro,606348,4,4906.13,0,1,1,0,0,0,0,2,1,0,0,0,0,0,1
Bajo,No_siniestro,620152,67,1834.08,0,0,0,0,0,0,0,0,0,0,0,0,1,0,1
Bajo,No_siniestro,627692,1,2214.06,0,0,0,0,0,0,0,0,0,1,0,0,0,0,1
Bajo,No_siniestro,639954,0,643.77,0,0,0,0,0,0,0,0,1,0,0,0,0,0,1
Bajo,No_siniestro,643042,2,343.66,0,0,0,0,0,0,0,0,1,0,0,0,0,0,1
Bajo,No_siniestro,645456,9,1214.15,0,0,0,0,0,0,0,0,1,0,0,0,0,0,1
Bajo,No_siniestro,645732,3,1078.77,0,1,0,0,0,0,0,1,1,0,0,0,0,0,1
Bajo,No_siniestro,724934,20,685.93,0,0,0,0,0,0,0,0,1,0,0,0,0,0,1
Bajo,No_siniestro,778858,5,2756.96,0,1,1,0,1,0,0,3,1,0,0,0,0,0,1
Alto,No_siniestro,126991,199,295.09,0,0,0,0,0,0,0,0,1,0,0,0,0,0,1
Alto,No_siniestro,393346,89,12661.46,0,1,0,1,0,0,0,2,0,0,1,0,0,0,1
Moderado,No_siniestro,4250,39,4216.36,131373.27,0,0,0,0,0,0,0,0,0,0,0,0,0,0
Moderado,No_siniestro,5575,52,909.88,0,0,0,0,0,1,0,1,0,0,0,0,0,0,0
Moderado,No_siniestro,8647,111,6019.4,0,0,0,0,0,0,0,0,0,0,0,0,0,0,0
Moderado,No_siniestro,10334,51,1508.69,0,0,0,0,0,0,0,0,0,0,0,0,0,0,0
Moderado,No_siniestro,11285,203,7802.1,56234.12,0,0,0,0,1,0,1,0,0,0,0,0,0,0
Moderado,No_siniestro,13466,117,842.77,0,0,0,0,0,0,0,0,0,0,0,0,0,0,0
Moderado,No_siniestro,13509,17,143.07,0,0,0,0,0,0,0,0,0,0,0,0,0,0,0
Moderado,No_siniestro,15215,65,8515.09,0,0,0,0,0,0,0,0,0,0,0,0,0,0,0
Moderado,No_siniestro,17659,201,34215.19,329889.75,0,0,0,0,0,0,0,0,0,0,0,0,0,0
Moderado,No_siniestro,19689,59,10516.67,78620.19,0,0,0,0,0,0,0,0,0,0,0,0,0,0
Moderado,No_siniestro,19988,132,22639.08,0,0,0,0,0,0,0,0,0,0,0,0,0,0,0
Moderado,No_siniestro,24311,64,19431.17,0,0,0,0,0,0,0,0,0,0,0,0,0,0,0
Moderado,No_siniestro,26135,21,2789.17,0,0,0,0,0,0,0,0,0,0,0,0,0,0,0
Moderado,No_siniestro,38227,90,13504.4,0,0,0,0,0,0,0,0,0,0,0,0,0,0,0
Moderado,No_siniestro,64351,41,2450.38,0,0,0,0,0,0,0,0,0,0,0,0,0,0,0
Moderado,No_siniestro,64760,39,981.48,0,0,0,0,3,2,0,5,0,0,0,0,0,0,0
Moderado,No_siniestro,64995,74,27460.71,0,0,0,0,0,0,0,0,0,0,0,0,0,0,0
Moderado,No_siniestro,69745,65,3189.3,0,0,0,0,0,0,0,0,0,0,0,0,0,0,0
Moderado,No_siniestro,69893,62,301.95,0,0,0,0,0,0,0,0,0,0,0,0,0,0,0
Moderado,No_siniestro,70482,100,15951.44,85712.37,0,0,0,0,0,0,0,0,0,0,0,0,0,0
Moderado,No_siniestro,71226,144,12916.34,0,0,0,0,0,0,0,0,0,0,0,0,0,0,0
Moderado,No_siniestro,71879,56,3131.51,0,0,0,0,0,0,0,0,0,0,0,0,0,0,0
Moderado,No_siniestro,73030,39,11096.41,0,0,0,0,0,0,0,0,0,0,0,0,0,0,0
Moderado,No_siniestro,73560,39,5946.27,0,0,0,0,0,0,0,0,0,0,0,0,0,0,0
Moderado,No_siniestro,73919,24,29975.39,0,0,0,0,0,0,0,0,0,0,0,0,0,0,0
Moderado,No_siniestro,75212,152,7110.45,53310.36,0,0,0,0,0,0,0,0,0,0,0,0,0,0
Moderado,No_siniestro,77142,144,832.35,28278.05,0,0,0,0,0,0,0,0,0,0,0,0,0,0
Moderado,No_siniestro,77813,168,80.35,0,0,0,0,0,0,0,0,0,0,0,0,0,0,0
Moderado,No_siniestro,78079,137,527.62,0,0,0,0,0,0,0,0,0,0,0,0,0,0,0
Moderado,No_siniestro,80119,70,14274.75,55055.62,0,0,0,0,0,0,0,0,0,0,0,0,0,0
Moderado,No_siniestro,81023,68,287.87,0,0,0,0,0,0,0,0,0,0,0,0,0,0,0
Moderado,No_siniestro,83853,128,2276.62,0,0,0,0,1,0,0,1,0,0,0,0,0,0,0
Moderado,No_siniestro,86564,37,1026.65,0,0,0,0,0,0,0,0,0,0,0,0,0,0,0
Moderado,No_siniestro,87158,89,317.2,0,0,0,0,0,0,0,0,0,0,0,0,0,0,0
Moderado,No_siniestro,87485,118,368.12,0,0,0,0,0,0,0,0,0,0,0,0,0,0,0
Moderado,No_siniestro,88153,117,4157.61,12835.67,0,0,0,0,0,0,0,0,0,0,0,0,0,0
Moderado,No_siniestro,93447,102,4469.78,79780.61,0,1,0,1,0,0,2,0,0,0,0,0,0,0
Moderado,No_siniestro,136221,109,40810.28,0,0,0,0,0,0,0,0,0,0,0,0,0,0,0
Moderado,Si_siniestro,137033,118,15576.62,0,0,0,0,0,0,0,0,0,0,0,0,0,0,0
Moderado,No_siniestro,137119,45,21313.86,109954.16,0,0,0,0,0,0,0,0,0,0,0,0,0,0
Moderado,No_siniestro,139033,111,1463.9,0,0,0,0,0,0,0,0,0,0,0,0,0,0,0
Moderado,No_siniestro,140862,52,26798.35,0,0,0,1,0,0,0,1,0,0,0,0,0,0,0
Moderado,No_siniestro,142027,55,580.79,76937.68,0,0,0,0,0,0,0,0,0,0,0,0,0,0
Moderado,No_siniestro,143845,52,7810.14,69705.95,0,0,0,0,0,0,0,0,0,0,0,0,0,0
Moderado,No_siniestro,146890,39,21719.07,442334.8,0,0,0,0,0,0,0,0,0,0,0,0,0,0
Moderado,No_siniestro,147445,91,16067.87,0,0,0,0,0,0,0,0,0,0,0,0,0,0,0
Moderado,No_siniestro,154229,175,1829.25,0,0,0,0,0,0,0,0,0,0,0,0,0,0,0
Moderado,No_siniestro,156903,29,14062.38,0,0,0,0,0,0,0,0,0,0,0,0,0,0,0
Moderado,No_siniestro,160178,8,12350.66,0,0,0,0,0,0,0,0,0,0,0,0,0,0,0
Moderado,No_siniestro,166076,106,18.58,0,0,0,0,0,0,1,1,0,0,0,0,0,0,0
Moderado,No_siniestro,192225,221,22330.15,0,1,0,0,0,0,0,1,0,0,0,0,0,0,0
Moderado,No_siniestro,194750,49,6321.52,0,0,0,0,0,0,0,0,0,0,0,0,0,0,0
Moderado,No_siniestro,195484,169,8681.48,0,0,0,0,0,0,0,0,0,0,0,0,0,0,0
Moderado,No_siniestro,197206,108,1409.14,144264.79,0,0,0,0,0,0,0,0,0,0,0,0,0,0
Moderado,No_siniestro,198270,49,24218.64,0,0,0,0,0,0,0,0,0,0,0,0,0,0,0
Moderado,No_siniestro,198383,107,31601.53,0,0,0,0,0,0,0,0,0,0,0,0,0,0,0
Moderado,No_siniestro,198595,19,617.88,0,0,0,0,0,0,0,0,0,0,0,0,0,0,0
Moderado,No_siniestro,199031,181,13127.52,0,0,0,0,0,0,0,0,0,0,0,0,0,0,0
Moderado,No_siniestro,199156,47,2570.46,0,0,0,0,0,0,0,0,0,0,0,0,0,0,0
Moderado,No_siniestro,201046,109,3878.8,14804.17,0,0,0,0,0,0,0,0,0,0,0,0,0,0
Moderado,No_siniestro,202381,70,9.83,280893.79,0,0,0,0,0,0,0,0,0,0,0,0,0,0
Moderado,No_siniestro,202385,33,14665.98,0,0,0,0,0,0,0,0,0,0,0,0,0,0,0
Moderado,No_siniestro,202452,121,10937.7,0,0,0,0,0,0,0,0,0,0,0,0,0,0,0
Moderado,No_siniestro,204702,24,3068.64,0,0,0,0,0,0,0,0,0,0,0,0,0,0,0
Moderado,No_siniestro,205557,17,597.6,0,0,0,0,0,0,0,0,0,0,0,0,0,0,0
Moderado,No_siniestro,209496,57,19992.75,31626.5,0,0,0,0,0,0,0,0,0,0,0,0,0,0
Moderado,No_siniestro,212909,79,706.86,0,0,0,0,0,0,0,0,0,0,0,0,0,0,0
Moderado,No_siniestro,215061,50,1436.12,31596.16,0,0,0,0,0,0,0,0,0,0,0,0,0,0
Moderado,No_siniestro,218185,87,3059.6,93566.06,0,0,0,0,2,1,3,0,0,0,0,0,0,0
Moderado,No_siniestro,221968,31,30753.5,0,0,0,0,0,0,0,0,0,0,0,0,0,0,0
Moderado,No_siniestro,251940,49,1287.87,0,0,0,0,0,0,0,0,0,0,0,0,0,0,0
Moderado,No_siniestro,252046,73,1990.95,0,0,0,0,0,0,0,0,0,0,0,0,0,0,0
Moderado,No_siniestro,252968,99,1211.36,0,0,0,0,0,0,0,0,0,0,0,0,0,0,0
Moderado,No_siniestro,253813,84,19331.5,0,0,0,0,0,0,0,0,0,0,0,0,0,0,0
Moderado,No_siniestro,255600,49,1120.13,0,0,0,0,0,0,0,0,0,0,0,0,0,0,0
Moderado,No_siniestro,256045,73,2325.01,0,0,0,0,0,0,0,0,0,0,0,0,0,0,0
Moderado,No_siniestro,257750,49,5509.4,0,0,0,0,0,0,0,0,0,0,0,0,0,0,0
Moderado,No_siniestro,259828,172,1233.84,0,0,0,0,0,0,0,0,0,0,0,0,0,0,0
Moderado,No_siniestro,260849,190,4711.89,0,0,1,0,0,0,0,1,0,0,0,0,0,0,0
Moderado,No_siniestro,261071,100,11477.86,92853.29,0,0,0,0,0,0,0,0,0,0,0,0,0,0
Moderado,No_siniestro,261983,29,12841.58,0,0,0,0,0,0,0,0,0,0,0,0,0,0,0
Moderado,No_siniestro,268572,131,22797.33,0,0,0,0,0,0,0,0,0,0,0,0,0,0,0
Moderado,No_siniestro,268654,92,1310.37,0,0,0,0,0,0,0,0,0,0,0,0,0,0,0
Moderado,No_siniestro,268730,49,8644.1,0,0,0,0,0,0,0,0,0,0,0,0,0,0,0
Moderado,No_siniestro,271094,123,1351.69,0,0,0,0,0,0,0,0,0,0,0,0,0,0,0
Moderado,No_siniestro,271193,100,2866.32,121159.43,0,0,0,0,0,0,0,0,0,0,0,0,0,0
Moderado,No_siniestro,276013,34,0.42,0,0,0,0,0,0,0,0,0,0,0,0,0,0,0
Moderado,No_siniestro,276455,208,3735.85,0,0,0,0,0,0,0,0,0,0,0,0,0,0,0
Moderado,No_siniestro,279213,147,24481.19,203964.27,0,0,0,0,0,1,1,0,0,0,0,0,0,0
Moderado,Si_siniestro,285996,46,55375.76,158109.6,0,0,0,0,0,0,0,0,0,0,0,0,0,0
Moderado,No_siniestro,287748,159,6556.34,20177.24,0,0,0,0,0,0,0,0,0,0,0,0,0,0
Moderado,No_siniestro,291198,67,25214.85,0,0,0,0,0,0,0,0,0,0,0,0,0,0,0
Moderado,No_siniestro,321176,102,1553.29,0,0,0,0,0,0,0,0,0,0,0,0,0,0,0
Moderado,No_siniestro,323045,89,1435.69,0,0,0,0,0,0,0,0,0,0,0,0,0,0,0
Moderado,No_siniestro,326854,128,21586.3,0,0,0,0,0,0,0,0,0,0,0,0,0,0,0
Moderado,No_siniestro,327190,44,3853.61,0,0,0,0,0,0,0,0,0,0,0,0,0,0,0
Moderado,No_siniestro,327259,121,16722.28,0,0,0,0,0,0,0,0,0,0,0,0,0,0,0
Moderado,No_siniestro,329665,174,19749.01,0,0,0,0,0,2,1,3,0,0,0,0,0,0,0
Moderado,No_siniestro,333775,31,6073.58,0,0,0,0,0,0,0,0,0,0,0,0,0,0,0
Moderado,No_siniestro,337495,112,14476.78,33946.22,0,0,0,0,0,0,0,0,0,0,0,0,0,0
Moderado,No_siniestro,349369,19,11.56,0,0,0,0,0,0,0,0,0,0,0,0,0,0,0
Moderado,No_siniestro,362200,44,278.04,0,0,0,0,0,0,0,0,0,0,0,0,0,0,0
Moderado,No_siniestro,374925,17,2969.47,0,0,0,0,0,0,0,0,0,0,0,0,0,0,0
Moderado,No_siniestro,381288,36,732,0,0,0,0,0,0,0,0,0,0,0,0,0,0,0
Moderado,No_siniestro,391252,73,33758.16,0,0,0,0,0,0,0,0,0,0,0,0,0,0,0
Moderado,No_siniestro,393789,85,42773.55,23446.52,0,0,0,0,0,0,0,0,0,0,0,0,0,0
Moderado,No_siniestro,395404,43,1168.65,0,0,0,0,0,0,0,0,0,0,0,0,0,0,0
Moderado,No_siniestro,395882,117,1425.99,0,0,0,0,0,0,0,0,0,0,0,0,0,0,0
Moderado,No_siniestro,407800,44,3640.34,0,0,0,0,0,0,0,0,0,0,0,0,0,0,0
Moderado,No_siniestro,413347,161,693.35,58642.33,0,0,0,0,0,0,0,0,0,0,0,0,0,0
Moderado,No_siniestro,418625,126,8273.22,37503.87,0,0,0,0,0,0,0,0,0,0,0,0,0,0
Moderado,No_siniestro,434718,89,23041.17,64357.12,0,0,0,0,0,0,0,0,0,0,0,0,0,0
Moderado,No_siniestro,435362,32,7079.69,46049.4,0,0,0,0,0,0,0,0,0,0,0,0,0,0
Moderado,No_siniestro,449279,28,208.5,0,0,0,0,0,0,0,0,0,0,0,0,0,0,0
Moderado,No_siniestro,449613,54,3358.23,0,0,0,0,0,0,0,0,0,0,0,0,0,0,0
Moderado,No_siniestro,451680,44,1008.98,0,0,0,0,0,0,0,0,0,0,0,0,0,0,0
Moderado,No_siniestro,455821,32,4850.94,0,0,0,0,0,0,0,0,0,0,0,0,0,0,0
Moderado,No_siniestro,458245,166,5498.6,0,0,0,0,0,0,0,0,0,0,0,0,0,0,0
Moderado,No_siniestro,458791,94,282.63,0,0,0,0,0,0,0,0,0,0,0,0,0,0,0
Moderado,No_siniestro,459206,115,20638.03,0,0,0,0,0,0,0,0,0,0,0,0,0,0,0
Moderado,No_siniestro,461208,91,14207.67,0,0,0,0,0,0,0,0,0,0,0,0,0,0,0
Moderado,No_siniestro,461457,111,1316.91,53377.36,0,0,0,0,0,0,0,0,0,0,0,0,0,0
Moderado,No_siniestro,461928,123,806.69,0,0,0,0,0,0,0,0,0,0,0,0,0,0,0
Moderado,No_siniestro,463282,26,1.01,0,0,0,0,0,0,0,0,0,0,0,0,0,0,0
Moderado,No_siniestro,464315,196,6256.47,26289.66,0,0,0,0,0,0,0,0,0,0,0,0,0,0
Moderado,No_siniestro,465571,98,1637.92,0,0,0,0,0,0,0,0,0,0,0,0,0,0,0
Moderado,Si_siniestro,466092,74,419.38,0,0,0,0,0,0,0,0,0,0,0,0,0,0,0
Moderado,No_siniestro,467331,81,2702.59,0,0,0,0,0,0,0,0,0,0,0,0,0,0,0
Moderado,No_siniestro,472769,47,52795.81,47829.27,0,1,0,0,0,0,1,0,0,0,0,0,0,0
Moderado,No_siniestro,474538,184,85.71,0,0,0,0,0,0,0,0,0,0,0,0,0,0,0
Moderado,No_siniestro,475499,125,19519.02,0,0,0,0,0,0,0,0,0,0,0,0,0,0,0
Moderado,No_siniestro,477282,82,41597.51,72566.53,0,0,0,0,0,0,0,0,0,0,0,0,0,0
Moderado,No_siniestro,477650,40,17395.11,107616.01,0,0,0,0,0,0,0,0,0,0,0,0,0,0
Moderado,No_siniestro,478928,42,5027.96,0,0,0,0,0,0,0,0,0,0,0,0,0,0,0
Moderado,No_siniestro,479409,80,15795.63,7447.71,0,0,0,0,0,0,0,0,0,0,0,0,0,0
Moderado,No_siniestro,481633,73,19219.75,0,0,0,0,0,0,0,0,0,0,0,0,0,0,0
Moderado,No_siniestro,486122,105,4503.27,0,0,0,0,0,0,0,0,0,0,0,0,0,0,0
Moderado,No_siniestro,489636,27,44905.4,0,0,0,0,0,0,0,0,0,0,0,0,0,0,0
Moderado,No_siniestro,514381,99,617.41,0,0,0,0,0,0,0,0,0,0,0,0,0,0,0
Moderado,No_siniestro,516870,40,18.4,0,0,0,0,0,0,0,0,0,0,0,0,0,0,0
Moderado,No_siniestro,519119,163,341.26,0,0,0,0,0,0,0,0,0,0,0,0,0,0,0
Moderado,No_siniestro,520390,40,522.29,0,0,0,0,0,0,0,0,0,0,0,0,0,0,0
Moderado,No_siniestro,523980,40,1235.92,0,0,0,0,0,0,0,0,0,0,0,0,0,0,0
Moderado,No_siniestro,524143,115,3698.98,0,0,0,0,0,0,0,0,0,0,0,0,0,0,0
Moderado,No_siniestro,529216,24,3870.72,0,0,0,0,0,0,0,0,0,0,0,0,0,0,0
Moderado,No_siniestro,533302,115,3548.07,0,0,0,0,0,0,0,0,0,0,0,0,0,0,0
Moderado,No_siniestro,552788,70,131.74,0,0,0,0,0,0,0,0,0,0,0,0,0,0,0
Moderado,No_siniestro,583532,130,3268.39,0,0,0,0,0,0,0,0,0,0,0,0,0,0,0
Moderado,No_siniestro,583666,29,99.72,0,0,0,0,0,0,0,0,0,0,0,0,0,0,0
Moderado,No_siniestro,585520,40,3808.41,0,0,0,0,0,0,0,0,0,0,0,0,0,0,0
Moderado,No_siniestro,586184,195,18608.97,0,0,0,0,0,0,0,0,0,0,0,0,0,0,0
Moderado,No_siniestro,588031,151,147.47,0,0,0,0,0,0,0,0,0,0,0,0,0,0,0
Moderado,No_siniestro,590377,190,10841.94,0,0,0,0,0,0,0,0,0,0,0,0,0,0,0
Moderado,No_siniestro,594057,46,27.38,0,0,0,0,0,0,0,0,0,0,0,0,0,0,0
Moderado,No_siniestro,598383,7,73.9,0,0,0,0,0,0,1,1,0,0,0,0,0,0,0
Moderado,No_siniestro,598514,191,7621.92,0,0,0,0,0,0,0,0,0,0,0,0,0,0,0
Moderado,No_siniestro,598700,40,15169.15,197365.72,0,0,0,0,0,0,0,0,0,0,0,0,0,0
Moderado,No_siniestro,607870,40,10212.5,98368.6,0,0,0,0,0,0,0,0,0,0,0,0,0,0
Moderado,No_siniestro,609628,8,114.55,0,0,0,0,0,0,0,0,0,0,0,0,0,0,0
Moderado,No_siniestro,610917,137,17764.98,75397.55,0,0,0,0,0,0,0,0,0,0,0,0,0,0
Moderado,Si_siniestro,617913,25,31661.23,0,0,0,0,0,0,0,0,0,0,0,0,0,0,0
Moderado,No_siniestro,629079,8,102.47,45069.41,0,0,0,0,0,0,0,0,0,0,0,0,0,0
Moderado,No_siniestro,647949,35,1956.86,0,0,0,0,0,0,0,0,0,0,0,0,0,0,0
Moderado,No_siniestro,648243,78,1653.5,50109.73,0,0,0,0,0,0,0,0,0,0,0,0,0,0
Moderado,No_siniestro,650514,112,27312.5,0,0,0,0,0,0,0,0,0,0,0,0,0,0,0
Moderado,No_siniestro,650746,123,16467.43,0,0,0,0,0,0,0,0,0,0,0,0,0,0,0
Moderado,No_siniestro,654456,102,2555.44,0,0,0,0,0,0,0,0,0,0,0,0,0,0,0
Moderado,No_siniestro,656628,78,13161.27,0,0,0,0,0,0,0,0,0,0,0,0,0,0,0
Moderado,No_siniestro,657096,190,82344.86,28810.7,0,0,0,0,0,0,0,0,0,0,0,0,0,0
Moderado,No_siniestro,657345,233,29850.19,0,0,0,0,0,0,0,0,0,0,0,0,0,0,0
Moderado,No_siniestro,658535,137,4704.16,0,0,1,0,0,0,0,1,0,0,0,0,0,0,0
Moderado,No_siniestro,661670,43,12679.78,0,0,0,0,0,0,0,0,0,0,0,0,0,0,0
Moderado,No_siniestro,662223,194,16660.04,0,0,0,0,0,0,0,0,0,0,0,0,0,0,0
Moderado,No_siniestro,663250,43,4588.45,73883.03,0,0,0,0,0,0,0,0,0,0,0,0,0,0
Moderado,No_siniestro,663850,43,2618.13,21411.48,0,0,0,0,0,0,0,0,0,0,0,0,0,0
Moderado,No_siniestro,665767,86,731.01,0,0,0,0,0,0,0,0,0,0,0,0,0,0,0
Moderado,No_siniestro,665825,42,1.04,122127.51,0,0,0,0,0,0,0,0,0,0,0,0,0,0
Moderado,No_siniestro,666789,168,746.75,0,0,0,0,0,0,0,0,0,0,0,0,0,0,0
Moderado,No_siniestro,671451,18,23454.77,0,0,0,0,0,0,0,0,0,0,0,0,0,0,0
Moderado,No_siniestro,673779,70,3792.46,0,0,0,0,0,0,0,0,0,0,0,0,0,0,0
Moderado,No_siniestro,674939,92,10,0,0,0,0,0,0,0,0,0,0,0,0,0,0,0
Moderado,No_siniestro,678705,85,551.11,0,0,0,0,0,0,0,0,0,0,0,0,0,0,0
Moderado,No_siniestro,679014,52,4265.84,0,0,0,0,0,0,0,0,0,0,0,0,0,0,0
Moderado,No_siniestro,680323,155,11716.55,0,0,0,0,0,0,0,0,0,0,0,0,0,0,0
Moderado,No_siniestro,680809,113,7041.14,0,0,0,0,0,0,0,0,0,0,0,0,0,0,0
Moderado,No_siniestro,684202,34,3919.28,0,0,0,0,0,0,0,0,0,0,0,0,0,0,0
Moderado,No_siniestro,689880,43,1598.28,38554.44,0,0,0,0,0,0,0,0,0,0,0,0,0,0
Moderado,No_siniestro,693427,70,2881.16,183135.68,0,0,0,0,0,0,0,0,0,0,0,0,0,0
Moderado,No_siniestro,717389,55,4399.45,79064.08,0,0,0,0,0,0,0,0,0,0,0,0,0,0
Moderado,No_siniestro,721789,73,38966.95,0,0,0,0,0,0,0,0,0,0,0,0,0,0,0
Moderado,No_siniestro,725230,43,961.08,0,0,0,0,0,0,0,0,0,0,0,0,0,0,0
Moderado,No_siniestro,727714,127,255.36,0,0,0,0,0,0,0,0,0,0,0,0,0,0,0
Moderado,No_siniestro,731040,43,90478.23,39698.78,0,0,0,0,0,0,0,0,0,0,0,0,0,0
Moderado,No_siniestro,734474,6,2518.93,113532.61,0,0,0,0,0,0,0,0,0,0,0,0,0,0
Moderado,No_siniestro,740333,106,18264.74,67809.01,0,0,0,0,0,0,0,0,0,0,0,0,0,0
Moderado,No_siniestro,740599,15,19900.55,0,1,0,1,0,1,1,4,0,0,0,0,0,0,0
Moderado,No_siniestro,740624,84,11293.09,62931.46,0,0,2,1,0,0,3,0,0,0,0,0,0,0
Moderado,No_siniestro,742016,13,1261.87,0,0,0,0,0,0,0,0,0,0,0,0,0,0,0
Moderado,No_siniestro,744246,79,15762.29,0,0,0,0,0,0,0,0,0,0,0,0,0,0,0
Moderado,No_siniestro,744268,226,61055.41,0,0,0,0,0,0,0,0,0,0,0,0,0,0,0
Moderado,No_siniestro,745293,107,385.74,17299.57,0,0,0,0,0,0,0,0,0,0,0,0,0,0
Moderado,No_siniestro,748069,190,17354.66,0,0,0,0,0,0,0,0,0,0,0,0,0,0,0
Moderado,No_siniestro,752274,108,642.76,119923.6,0,0,0,0,0,0,0,0,0,0,0,0,0,0
Moderado,No_siniestro,768313,41,2674.14,92831.91,0,0,0,0,0,0,0,0,0,0,0,0,0,0
Moderado,No_siniestro,770807,31,37689.4,78529.76,0,0,0,0,0,0,0,0,0,0,0,0,0,0
Moderado,No_siniestro,771043,96,31407.82,103541.96,0,0,0,0,0,0,0,0,0,0,0,0,0,0
Moderado,No_siniestro,170940,42,16990.66,0,0,0,0,0,0,0,0,0,0,0,0,0,0,0
Moderado,No_siniestro,318219,132,0,0,0,0,0,0,0,0,0,0,0,0,0,0,0,0
Moderado,No_siniestro,532984,12,44202.4,0,0,0,0,0,0,1,1,0,0,0,0,0,0,0
Moderado,No_siniestro,586743,32,0,0,0,7,7,6,5,4,29,0,0,0,0,0,0,0
Medio_bajo,No_siniestro,185,44,604.86,0,0,0,0,0,0,0,0,0,0,0,0,0,0,0
Medio_bajo,No_siniestro,238,79,1006.21,0,0,0,0,0,0,0,0,0,0,0,0,0,0,0
Medio_bajo,No_siniestro,346,102,299.23,0,0,0,0,0,0,0,0,0,0,0,0,0,0,0
Medio_bajo,No_siniestro,460,39,645.19,0,0,0,0,0,0,0,0,0,0,0,0,0,0,0
Medio_bajo,No_siniestro,549,109,218,0,0,0,0,0,0,0,0,0,0,0,0,0,0,0
Medio_bajo,No_siniestro,559,183,10.32,0,0,0,0,0,0,0,0,0,0,0,0,0,0,0
Medio_bajo,No_siniestro,974,93,1310.43,0,0,0,0,0,0,0,0,0,0,0,0,0,0,0
Medio_bajo,No_siniestro,1083,119,5085.55,0,0,0,0,0,0,0,0,0,0,0,0,0,0,0
Medio_bajo,No_siniestro,1186,9,4871.7,0,0,0,0,0,0,1,1,0,0,0,0,0,0,0
Medio_bajo,No_siniestro,1196,17,193.4,0,0,0,0,0,0,0,0,0,0,0,0,0,0,0
Medio_bajo,No_siniestro,1454,122,83.34,0,0,0,0,0,0,0,0,0,0,0,0,0,0,0
Medio_bajo,No_siniestro,1552,59,39.77,0,0,0,0,0,0,0,0,0,0,0,0,0,0,0
Medio_bajo,No_siniestro,1677,178,3054.95,0,0,0,0,0,0,0,0,0,0,0,0,0,0,0
Medio_bajo,No_siniestro,2070,39,1174.48,0,0,0,0,0,0,0,0,0,0,0,0,0,0,0
Medio_bajo,No_siniestro,2161,61,91.77,59503.86,0,0,0,0,0,0,0,0,0,0,0,0,0,0
Medio_bajo,Si_siniestro,2646,50,8.35,0,1,0,0,0,0,0,1,0,0,0,0,0,0,0
Medio_bajo,No_siniestro,2652,87,7240.69,0,0,0,0,0,0,1,1,0,0,0,0,0,0,0
Medio_bajo,No_siniestro,3666,15,276.72,0,0,0,0,0,0,0,0,0,0,0,0,0,0,0
Medio_bajo,No_siniestro,3760,39,3333.73,0,0,0,0,0,0,0,0,0,0,0,0,0,0,0
Medio_bajo,No_siniestro,3876,46,0.11,0,0,0,0,0,0,0,0,0,0,0,0,0,0,0
Medio_bajo,No_siniestro,4447,24,6961.42,0,0,0,0,0,0,0,0,0,0,0,0,0,0,0
Medio_bajo,No_siniestro,4738,43,167.9,0,0,0,0,0,0,0,0,0,0,0,0,0,0,0
Medio_bajo,No_siniestro,5302,69,7927.79,16091.64,0,0,0,0,0,0,0,0,0,0,0,0,0,0
Medio_bajo,No_siniestro,6007,48,180.99,0,0,0,0,0,0,0,0,0,0,0,0,0,0,0
Medio_bajo,No_siniestro,6061,110,3061.62,0,0,0,0,0,0,0,0,0,0,0,0,0,0,0
Medio_bajo,No_siniestro,6079,102,1195.58,0,0,0,0,0,0,0,0,0,0,0,0,0,0,0
Medio_bajo,No_siniestro,6166,29,0.25,0,0,0,0,0,0,0,0,0,0,0,0,0,0,0
Medio_bajo,No_siniestro,6751,172,2934.36,32561.89,0,0,0,0,0,0,0,0,0,0,0,0,0,0
Medio_bajo,No_siniestro,7004,32,846.44,0,0,0,0,0,0,0,0,0,0,0,0,0,0,0
Medio_bajo,No_siniestro,7946,70,233.03,2746.64,1,0,0,0,0,0,1,0,0,0,0,0,0,0
Medio_bajo,No_siniestro,8493,50,3172.73,0,0,0,0,0,0,0,0,0,0,0,0,0,0,0
Medio_bajo,No_siniestro,9198,90,5733.35,1609.72,0,0,0,0,0,0,0,0,0,0,0,0,0,0
Medio_bajo,No_siniestro,9497,156,57.87,0,0,0,0,0,0,0,0,0,0,0,0,0,0,0
Medio_bajo,No_siniestro,9686,114,11245.63,0,0,0,0,1,0,0,1,0,0,0,0,0,0,0
Medio_bajo,Si_siniestro,9979,73,145.86,0,1,0,0,0,0,0,1,0,0,0,0,0,0,0
Medio_bajo,No_siniestro,10080,39,17095.92,0,0,0,0,0,0,0,0,0,0,0,0,0,0,0
Medio_bajo,No_siniestro,10081,190,232.16,0,0,0,0,0,0,0,0,0,0,0,0,0,0,0
Medio_bajo,No_siniestro,10141,10,1144.69,0,0,0,0,0,0,0,0,0,0,0,0,0,0,0
Medio_bajo,No_siniestro,10582,136,385.78,0,0,0,1,0,0,0,1,0,0,0,0,0,0,0
Medio_bajo,No_siniestro,10848,112,3363.16,0,0,0,0,0,0,0,0,0,0,0,0,0,0,0
Medio_bajo,No_siniestro,11329,119,525.4,38458.02,0,0,0,0,0,0,0,0,0,0,0,0,0,0
Medio_bajo,No_siniestro,11420,39,11289.43,0,0,0,0,0,0,0,0,0,0,0,0,0,0,0
Medio_bajo,No_siniestro,11534,55,5619.37,0,0,0,0,0,0,0,0,0,0,0,0,0,0,0
Medio_bajo,No_siniestro,11909,151,416.72,0,0,0,0,0,0,0,0,0,0,0,0,0,0,0
Medio_bajo,No_siniestro,12393,51,1.3,0,0,0,0,0,0,0,0,0,0,0,0,0,0,0
Medio_bajo,No_siniestro,12424,22,13115.89,0,0,0,0,0,0,0,0,0,0,0,0,0,0,0
Medio_bajo,No_siniestro,13142,63,5064.26,0,0,0,0,0,0,0,0,0,0,0,0,0,0,0
Medio_bajo,No_siniestro,13163,102,12176.67,0,0,0,0,0,0,0,0,0,0,0,0,0,0,0
Medio_bajo,No_siniestro,13275,8,4074.54,48564.6,1,1,1,1,0,0,4,0,0,0,0,0,0,0
Medio_bajo,No_siniestro,13704,83,315.18,0,0,0,0,0,0,0,0,0,0,0,0,0,0,0
Medio_bajo,No_siniestro,13905,32,807.54,0,0,0,0,0,0,0,0,0,0,0,0,0,0,0
Medio_bajo,No_siniestro,14039,178,1274.28,0,0,0,0,0,0,0,0,0,0,0,0,0,0,0
Medio_bajo,No_siniestro,14063,41,58.05,0,0,0,0,0,0,0,0,0,0,0,0,0,0,0
Medio_bajo,No_siniestro,14213,76,107.48,0,0,0,0,0,0,0,0,0,0,0,0,0,0,0
Medio_bajo,No_siniestro,15043,119,2985.19,0,0,0,0,0,0,0,0,0,0,0,0,0,0,0
Medio_bajo,No_siniestro,15318,42,12.79,29148.38,0,0,0,0,0,0,0,0,0,0,0,0,0,0
Medio_bajo,No_siniestro,15387,135,56.6,0,0,0,0,0,0,0,0,0,0,0,0,0,0,0
Medio_bajo,No_siniestro,15447,47,2186.07,0,0,0,0,0,0,0,0,0,0,0,0,0,0,0
Medio_bajo,No_siniestro,15466,9,4.58,0,0,0,0,0,0,0,0,0,0,0,0,0,0,0
Medio_bajo,No_siniestro,15591,76,9555.51,90602.37,0,0,0,0,0,0,0,0,0,0,0,0,0,0
Medio_bajo,No_siniestro,16241,56,3.12,0,0,0,0,0,0,0,0,0,0,0,0,0,0,0
Medio_bajo,No_siniestro,16377,109,1994.69,0,0,0,0,0,0,0,0,0,0,0,0,0,0,0
Medio_bajo,No_siniestro,16587,32,3448.6,0,0,0,0,0,0,0,0,0,0,0,0,0,0,0
Medio_bajo,No_siniestro,16666,20,8392.13,0,0,0,0,0,0,0,0,0,0,0,0,0,0,0
Medio_bajo,No_siniestro,16886,81,876.91,0,0,0,0,0,0,1,1,0,0,0,0,0,0,0
Medio_bajo,No_siniestro,17195,144,159.82,0,0,0,0,0,0,0,0,0,0,0,0,0,0,0
Medio_bajo,No_siniestro,17399,54,2208.32,0,0,0,0,0,0,0,0,0,0,0,0,0,0,0
Medio_bajo,Si_siniestro,17633,50,98.31,0,0,0,0,0,0,0,0,0,0,0,0,0,0,0
Medio_bajo,No_siniestro,18095,120,4880.35,0,0,0,0,0,0,0,0,0,0,0,0,0,0,0
Medio_bajo,No_siniestro,18540,39,1320.6,0,0,0,0,0,0,0,0,0,0,0,0,0,0,0
Medio_bajo,No_siniestro,19231,24,157.76,0,0,0,0,0,0,0,0,0,0,0,0,0,0,0
Medio_bajo,No_siniestro,19322,24,1476.19,0,0,0,0,0,0,0,0,0,0,0,0,0,0,0
Medio_bajo,No_siniestro,19329,13,2975.28,13738.35,0,0,0,0,0,0,0,0,0,0,0,0,0,0
Medio_bajo,No_siniestro,19688,95,50.13,0,0,0,1,0,0,0,1,0,0,0,0,0,0,0
Medio_bajo,No_siniestro,19708,38,2840.47,0,0,0,0,0,1,1,2,0,0,0,0,0,0,0
Medio_bajo,No_siniestro,19816,46,5430.87,0,0,0,0,0,0,0,0,0,0,0,0,0,0,0
Medio_bajo,No_siniestro,20143,143,24.92,0,0,0,0,0,0,0,0,0,0,0,0,0,0,0
Medio_bajo,No_siniestro,20517,102,6881.81,0,0,0,0,0,0,0,0,0,0,0,0,0,0,0
Medio_bajo,No_siniestro,20860,39,310.93,0,0,0,0,0,0,0,0,0,0,0,0,0,0,0
Medio_bajo,No_siniestro,22749,55,4303.74,0,0,0,0,0,0,0,0,0,0,0,0,0,0,0
Medio_bajo,No_siniestro,23026,40,906.5,0,0,0,0,0,0,0,0,0,0,0,0,0,0,0
Medio_bajo,No_siniestro,23113,79,2833.5,0,0,0,0,0,0,0,0,0,0,0,0,0,0,0
Medio_bajo,No_siniestro,23143,100,1438.7,0,0,0,0,0,0,0,0,0,0,0,0,0,0,0
Medio_bajo,No_siniestro,23362,122,152.47,0,0,0,0,0,0,0,0,0,0,0,0,0,0,0
Medio_bajo,No_siniestro,23527,189,761.32,0,0,0,0,0,0,0,0,0,0,0,0,0,0,0
Medio_bajo,No_siniestro,23567,11,4852.17,0,0,0,0,0,0,0,0,0,0,0,0,0,0,0
Medio_bajo,No_siniestro,23629,9,3820.77,0,0,0,0,0,0,0,0,0,0,0,0,0,0,0
Medio_bajo,No_siniestro,24603,38,8403.57,0,0,0,0,0,0,0,0,0,0,0,0,0,0,0
Medio_bajo,No_siniestro,25266,22,1317.64,0,0,0,0,0,0,0,0,0,0,0,0,0,0,0
Medio_bajo,No_siniestro,25474,64,4259.44,0,0,0,0,0,0,0,0,0,0,0,0,0,0,0
Medio_bajo,No_siniestro,25581,75,3499.66,0,0,0,0,0,0,0,0,0,0,0,0,0,0,0
Medio_bajo,No_siniestro,25703,25,2125.73,0,0,0,1,0,0,0,1,0,0,0,0,0,0,0
Medio_bajo,No_siniestro,26527,51,15795.81,0,0,0,0,1,0,1,2,0,0,0,0,0,0,0
Medio_bajo,No_siniestro,26936,83,266.78,0,0,0,0,0,0,0,0,0,0,0,0,0,0,0
Medio_bajo,No_siniestro,27225,72,3278.72,0,0,0,0,0,0,0,0,0,0,0,0,0,0,0
Medio_bajo,No_siniestro,27620,39,3165.11,0,0,0,0,0,0,0,0,0,0,0,0,0,0,0
Medio_bajo,No_siniestro,28039,22,1519.69,0,0,0,0,0,0,1,1,0,0,0,0,0,0,0
Medio_bajo,No_siniestro,28435,10,1200.07,0,0,0,0,0,0,0,0,0,0,0,0,0,0,0
Medio_bajo,No_siniestro,28920,39,2162.5,0,0,0,0,0,0,0,0,0,0,0,0,0,0,0
Medio_bajo,No_siniestro,29140,39,8627.09,0,0,0,0,0,0,0,0,0,0,0,0,0,0,0
Medio_bajo,No_siniestro,29579,122,2009.26,0,0,0,0,0,0,0,0,0,0,0,0,0,0,0
Medio_bajo,No_siniestro,29667,162,780.14,0,0,0,0,0,0,0,0,0,0,0,0,0,0,0
Medio_bajo,No_siniestro,30501,35,67.68,0,0,0,0,0,0,0,0,0,0,0,0,0,0,0
Medio_bajo,No_siniestro,30567,60,301.15,0,0,0,0,0,0,0,0,0,0,0,0,0,0,0
Medio_bajo,No_siniestro,30724,7,11683.44,0,0,0,0,0,0,1,1,0,0,0,0,0,0,0
Medio_bajo,No_siniestro,31347,57,2137.49,0,0,0,0,0,0,0,0,0,0,0,0,0,0,0
Medio_bajo,No_siniestro,33190,39,11736.86,0,0,0,0,0,0,0,0,0,0,0,0,0,0,0
Medio_bajo,No_siniestro,33829,105,8.52,0,0,0,0,0,0,0,0,0,0,0,0,0,0,0
Medio_bajo,Si_siniestro,34875,9,1854.24,0,0,0,0,0,0,0,0,0,0,0,0,0,0,0
Medio_bajo,No_siniestro,35468,9,4776.2,0,0,0,0,0,1,1,2,0,0,0,0,0,0,0
Medio_bajo,No_siniestro,35576,49,1056.47,0,0,0,0,0,0,1,1,0,0,0,0,0,0,0
Medio_bajo,Si_siniestro,36071,61,157.1,0,1,0,0,0,0,0,1,0,0,0,0,0,0,0
Medio_bajo,No_siniestro,36687,44,20339.58,0,1,1,1,0,2,1,6,0,0,0,0,0,0,0
Medio_bajo,No_siniestro,36761,31,2561.46,0,0,0,0,0,0,1,1,0,0,0,0,0,0,0
Medio_bajo,No_siniestro,36939,110,1766.48,0,0,0,0,0,0,0,0,0,0,0,0,0,0,0
Medio_bajo,No_siniestro,37059,9,3245.78,0,0,0,0,0,1,1,2,0,0,0,0,0,0,0
Medio_bajo,No_siniestro,37426,64,2209.21,0,0,0,0,0,0,0,0,0,0,0,0,0,0,0
Medio_bajo,No_siniestro,37880,39,3138.74,0,0,0,0,0,0,0,0,0,0,0,0,0,0,0
Medio_bajo,No_siniestro,39531,39,5203.16,0,0,0,0,0,0,0,0,0,0,0,0,0,0,0
Medio_bajo,No_siniestro,40008,60,285.53,0,0,0,0,0,0,0,0,0,0,0,0,0,0,0
Medio_bajo,No_siniestro,40452,41,464.68,0,0,0,0,0,0,0,0,0,0,0,0,0,0,0
Medio_bajo,No_siniestro,40705,44,9833.19,0,0,0,1,0,0,0,1,0,0,0,0,0,0,0
Medio_bajo,No_siniestro,41347,44,55.12,0,0,0,0,0,0,0,0,0,0,0,0,0,0,0
Medio_bajo,No_siniestro,42846,28,870.71,0,0,0,0,0,0,0,0,0,0,0,0,0,0,0
Medio_bajo,No_siniestro,43066,7,1015.86,0,0,0,0,0,0,0,0,0,0,0,0,0,0,0
Medio_bajo,No_siniestro,43127,99,7363.23,0,0,0,0,0,0,0,0,0,0,0,0,0,0,0
Medio_bajo,No_siniestro,43981,60,5817.63,0,0,0,0,0,0,0,0,0,0,0,0,0,0,0
Medio_bajo,No_siniestro,44128,79,1482.46,0,0,0,0,0,0,0,0,0,0,0,0,0,0,0
Medio_bajo,No_siniestro,44477,21,1124.28,0,0,0,0,0,0,0,0,0,0,0,0,0,0,0
Medio_bajo,No_siniestro,45303,34,601.8,0,0,0,0,0,0,0,0,0,0,0,0,0,0,0
Medio_bajo,No_siniestro,45687,27,1819.16,0,0,0,0,0,0,1,1,0,0,0,0,0,0,0
Medio_bajo,No_siniestro,45982,48,2630.04,0,0,0,0,0,0,0,0,0,0,0,0,0,0,0
Medio_bajo,No_siniestro,46129,9,2431.56,0,0,0,0,0,0,0,0,0,0,0,0,0,0,0
Medio_bajo,No_siniestro,46194,38,4489.25,0,0,0,0,0,0,0,0,0,0,0,0,0,0,0
Medio_bajo,No_siniestro,49740,39,68.37,0,0,0,0,0,0,0,0,0,0,0,0,0,0,0
Medio_bajo,No_siniestro,49787,15,488.05,0,0,0,0,0,0,0,0,0,0,0,0,0,0,0
Medio_bajo,No_siniestro,50847,20,11089.66,0,0,0,0,0,0,0,0,0,0,0,0,0,0,0
Medio_bajo,No_siniestro,50914,45,298.69,0,0,0,0,0,0,0,0,0,0,0,0,0,0,0
Medio_bajo,No_siniestro,53863,29,764.62,0,0,0,1,0,0,1,2,0,0,0,0,0,0,0
Medio_bajo,No_siniestro,55294,38,3264.3,0,0,0,0,0,0,0,0,0,0,0,0,0,0,0
Medio_bajo,No_siniestro,55584,42,1913.09,0,0,0,0,0,0,0,0,0,0,0,0,0,0,0
Medio_bajo,No_siniestro,59457,56,633.09,0,0,0,0,0,0,0,0,0,0,0,0,0,0,0
Medio_bajo,No_siniestro,60086,113,1224.15,0,0,0,1,0,0,0,1,0,0,0,0,0,0,0
Medio_bajo,No_siniestro,60630,39,0.27,0,0,0,0,0,1,1,2,0,0,0,0,0,0,0
Medio_bajo,No_siniestro,61698,95,50.78,0,0,0,0,0,0,0,0,0,0,0,0,0,0,0
Medio_bajo,No_siniestro,61802,72,191.99,0,0,0,0,0,0,0,0,0,0,0,0,0,0,0
Medio_bajo,No_siniestro,61980,39,8247.68,0,0,0,0,0,0,1,1,0,0,0,0,0,0,0
Medio_bajo,No_siniestro,61996,105,1196.49,0,0,0,0,0,0,0,0,0,0,0,0,0,0,0
Medio_bajo,No_siniestro,62451,173,4885.69,12376.53,0,0,0,0,0,0,0,0,0,0,0,0,0,0
Medio_bajo,No_siniestro,63024,162,446.16,0,0,0,0,0,0,0,0,0,0,0,0,0,0,0
Medio_bajo,No_siniestro,63090,39,3025.6,0,0,0,0,0,0,0,0,0,0,0,0,0,0,0
Medio_bajo,No_siniestro,63215,88,174.42,0,0,0,0,0,0,0,0,0,0,0,0,0,0,0
Medio_bajo,No_siniestro,63608,23,96.57,0,0,0,0,0,0,0,0,0,0,0,0,0,0,0
Medio_bajo,No_siniestro,63842,22,310.27,0,0,0,0,0,0,0,0,0,0,0,0,0,0,0
Medio_bajo,No_siniestro,64154,33,911.75,0,0,0,0,0,0,0,0,0,0,0,0,0,0,0
Medio_bajo,No_siniestro,64211,39,3635.97,0,0,0,0,0,0,0,0,0,0,0,0,0,0,0
Medio_bajo,No_siniestro,64372,64,842.59,0,0,0,0,0,0,0,0,0,0,0,0,0,0,0
Medio_bajo,No_siniestro,64905,29,9569.42,0,0,0,0,0,0,0,0,0,0,0,0,0,0,0
Medio_bajo,No_siniestro,65047,152,7585.67,0,0,0,0,0,0,0,0,0,0,0,0,0,0,0
Medio_bajo,No_siniestro,65423,99,11183.14,10150.46,0,0,0,1,0,0,1,0,0,0,0,0,0,0
Medio_bajo,No_siniestro,65697,223,4983.06,0,0,0,0,0,0,0,0,0,0,0,0,0,0,0
Medio_bajo,No_siniestro,65816,139,147.24,0,0,0,0,0,0,0,0,0,0,0,0,0,0,0
Medio_bajo,No_siniestro,65823,112,3333.05,0,0,0,1,0,0,1,2,0,0,0,0,0,0,0
Medio_bajo,No_siniestro,66118,78,6790.74,0,0,0,0,0,0,0,0,0,0,0,0,0,0,0
Medio_bajo,No_siniestro,66932,66,502.29,0,0,0,0,0,0,0,0,0,0,0,0,0,0,0
Medio_bajo,No_siniestro,67382,81,2187.69,0,0,0,0,0,0,0,0,0,0,0,0,0,0,0
Medio_bajo,No_siniestro,67424,119,1261.92,0,0,0,0,0,0,0,0,0,0,0,0,0,0,0
Medio_bajo,No_siniestro,67637,42,1198.84,0,0,0,0,0,0,0,0,0,0,0,0,0,0,0
Medio_bajo,No_siniestro,67869,204,7676.58,0,0,0,0,0,0,0,0,0,0,0,0,0,0,0
Medio_bajo,No_siniestro,68105,97,6911.89,0,0,0,0,0,0,0,0,0,0,0,0,0,0,0
Medio_bajo,No_siniestro,68350,39,1905.66,0,0,0,0,0,0,0,0,0,0,0,0,0,0,0
Medio_bajo,No_siniestro,68508,21,15109.28,0,0,0,0,0,0,0,0,0,0,0,0,0,0,0
Medio_bajo,No_siniestro,68690,39,5016.46,0,0,0,0,1,0,0,1,0,0,0,0,0,0,0
Medio_bajo,No_siniestro,69113,9,62.74,0,0,0,0,0,0,0,0,0,0,0,0,0,0,0
Medio_bajo,No_siniestro,69138,56,644.66,34699.79,0,0,0,0,0,0,0,0,0,0,0,0,0,0
Medio_bajo,No_siniestro,69173,8,1401.55,0,0,0,0,0,0,0,0,0,0,0,0,0,0,0
Medio_bajo,No_siniestro,69339,66,2161.11,0,0,0,0,0,0,0,0,0,0,0,0,0,0,0
Medio_bajo,Si_siniestro,70017,82,14947.78,0,0,0,0,0,0,0,0,0,0,0,0,0,0,0
Medio_bajo,No_siniestro,71033,29,193.62,0,0,0,0,0,0,0,0,0,0,0,0,0,0,0
Medio_bajo,No_siniestro,71118,32,696.27,0,0,0,0,0,0,0,0,0,0,0,0,0,0,0
Medio_bajo,No_siniestro,71679,38,849.17,0,0,0,0,0,0,0,0,0,0,0,0,0,0,0
Medio_bajo,No_siniestro,72646,43,9244.15,0,0,0,0,0,0,0,0,0,0,0,0,0,0,0
Medio_bajo,No_siniestro,72847,213,619.96,0,0,0,0,0,0,0,0,0,0,0,0,0,0,0
Medio_bajo,No_siniestro,73023,27,1196.72,0,0,7,7,7,7,7,35,0,0,0,0,0,0,0
Medio_bajo,No_siniestro,73231,27,5383.51,0,0,0,0,0,0,0,0,0,0,0,0,0,0,0
Medio_bajo,No_siniestro,73983,78,7195.16,0,0,0,0,0,1,0,1,0,0,0,0,0,0,0
Medio_bajo,No_siniestro,74349,55,599.49,0,0,0,0,0,0,0,0,0,0,0,0,0,0,0
Medio_bajo,No_siniestro,74351,16,0.7,0,0,0,0,0,0,0,0,0,0,0,0,0,0,0
Medio_bajo,No_siniestro,74872,20,568.3,0,0,0,0,0,0,0,0,0,0,0,0,0,0,0
Medio_bajo,No_siniestro,76679,137,158.9,0,0,0,0,0,0,0,0,0,0,0,0,0,0,0
Medio_bajo,No_siniestro,76767,202,6458.15,0,0,0,0,0,0,0,0,0,0,0,0,0,0,0
Medio_bajo,No_siniestro,76801,73,1161.57,0,0,0,1,1,0,1,3,0,0,0,0,0,0,0
Medio_bajo,No_siniestro,77171,178,2448.82,0,0,0,0,0,0,0,0,0,0,0,0,0,0,0
Medio_bajo,No_siniestro,77202,15,0.02,0,0,0,0,0,0,0,0,0,0,0,0,0,0,0
Medio_bajo,No_siniestro,77264,143,6296.83,0,0,0,0,0,0,1,1,0,0,0,0,0,0,0
Medio_bajo,No_siniestro,77414,183,2575.12,0,0,0,0,0,0,0,0,0,0,0,0,0,0,0
Medio_bajo,No_siniestro,77507,13,963.91,0,0,0,0,0,0,0,0,0,0,0,0,0,0,0
Medio_bajo,No_siniestro,77673,214,8304.44,0,0,0,0,0,0,0,0,0,0,0,0,0,0,0
Medio_bajo,Si_siniestro,77838,7,612.79,0,0,0,0,1,0,0,1,0,0,0,0,0,0,0
Medio_bajo,Si_siniestro,78022,9,15058.4,0,1,0,0,0,0,1,2,0,0,0,0,0,0,0
Medio_bajo,No_siniestro,78188,57,12401.4,0,0,0,0,0,0,0,0,0,0,0,0,0,0,0
Medio_bajo,No_siniestro,78307,74,171.66,64071.33,0,0,0,0,0,0,0,0,0,0,0,0,0,0
Medio_bajo,No_siniestro,78421,49,3618,0,0,0,0,0,0,0,0,0,0,0,0,0,0,0
Medio_bajo,No_siniestro,78490,39,817.88,0,0,1,0,1,0,0,2,0,0,0,0,0,0,0
Medio_bajo,No_siniestro,78529,21,1031.55,2446.99,0,0,0,0,0,0,0,0,0,0,0,0,0,0
Medio_bajo,No_siniestro,78570,39,41.89,0,1,0,0,0,0,0,1,0,0,0,0,0,0,0
Medio_bajo,No_siniestro,78642,76,27.14,0,0,0,0,0,0,0,0,0,0,0,0,0,0,0
Medio_bajo,Si_siniestro,80110,39,5476.8,0,0,0,0,0,0,0,0,0,0,0,0,0,0,0
Medio_bajo,No_siniestro,80226,176,6501.9,0,0,0,0,0,0,0,0,0,0,0,0,0,0,0
Medio_bajo,No_siniestro,80260,39,6.98,0,0,1,0,0,0,0,1,0,0,0,0,0,0,0
Medio_bajo,No_siniestro,80287,117,5229.23,63202.12,0,0,0,0,0,1,1,0,0,0,0,0,0,0
Medio_bajo,No_siniestro,80652,20,2034.16,0,0,0,0,0,0,0,0,0,0,0,0,0,0,0
Medio_bajo,No_siniestro,80699,45,451.91,0,0,2,1,0,0,0,3,0,0,0,0,0,0,0
Medio_bajo,No_siniestro,81480,39,2276.7,0,0,0,0,0,0,0,0,0,0,0,0,0,0,0
Medio_bajo,No_siniestro,81939,24,2740.85,0,0,0,0,0,0,0,0,0,0,0,0,0,0,0
Medio_bajo,No_siniestro,82028,12,1114.53,0,1,0,0,0,0,0,1,0,0,0,0,0,0,0
Medio_bajo,No_siniestro,82202,14,9393.82,0,0,0,0,0,0,0,0,0,0,0,0,0,0,0
Medio_bajo,No_siniestro,82293,59,179.84,0,0,0,0,0,0,0,0,0,0,0,0,0,0,0
Medio_bajo,No_siniestro,82709,25,9980.47,0,0,0,0,0,0,0,0,0,0,0,0,0,0,0
Medio_bajo,Si_siniestro,82761,35,2943.84,0,0,0,1,0,0,0,1,0,0,0,0,0,0,0
Medio_bajo,No_siniestro,83180,39,390.22,0,0,0,0,0,0,0,0,0,0,0,0,0,0,0
Medio_bajo,No_siniestro,83745,57,224.27,0,0,0,0,0,0,0,0,0,0,0,0,0,0,0
Medio_bajo,Si_siniestro,84121,56,7545.85,0,0,0,0,1,0,0,1,0,0,0,0,0,0,0
Medio_bajo,No_siniestro,84256,13,3099.61,0,0,0,0,0,0,0,0,0,0,0,0,0,0,0
Medio_bajo,No_siniestro,84368,6,8782.04,40016.06,0,0,0,0,0,0,0,0,0,0,0,0,0,0
Medio_bajo,No_siniestro,84574,50,2151.32,0,0,0,0,0,0,1,1,0,0,0,0,0,0,0
Medio_bajo,No_siniestro,85078,40,2503.62,0,0,0,0,0,0,1,1,0,0,0,0,0,0,0
Medio_bajo,No_siniestro,85537,7,490.34,0,0,0,0,0,0,0,0,0,0,0,0,0,0,0
Medio_bajo,No_siniestro,86985,38,10.35,0,0,0,0,0,0,0,0,0,0,0,0,0,0,0
Medio_bajo,No_siniestro,87228,63,2504.53,0,0,0,0,0,0,0,0,0,0,0,0,0,0,0
Medio_bajo,No_siniestro,87450,39,2905.84,0,0,0,0,0,0,0,0,0,0,0,0,0,0,0
Medio_bajo,No_siniestro,87548,44,12598.34,0,0,0,0,0,0,0,0,0,0,0,0,0,0,0
Medio_bajo,No_siniestro,88231,144,5926.28,8255.75,0,0,0,0,0,0,0,0,0,0,0,0,0,0
Medio_bajo,No_siniestro,88454,78,3126.35,0,0,0,0,0,0,0,0,0,0,0,0,0,0,0
Medio_bajo,No_siniestro,88958,63,239.84,0,0,0,0,0,0,0,0,0,0,0,0,0,0,0
Medio_bajo,No_siniestro,89321,6,1461.36,0,0,0,0,0,0,0,0,0,0,0,0,0,0,0
Medio_bajo,No_siniestro,89341,143,122.37,25032.47,0,0,0,0,0,0,0,0,0,0,0,0,0,0
Medio_bajo,No_siniestro,89442,24,1170.11,0,0,0,0,0,0,0,0,0,0,0,0,0,0,0
Medio_bajo,No_siniestro,89711,84,6091.74,30312.43,0,0,0,0,0,0,0,0,0,0,0,0,0,0
Medio_bajo,No_siniestro,89842,25,845.17,0,0,0,0,0,0,0,0,0,0,0,0,0,0,0
Medio_bajo,No_siniestro,90482,75,15.98,0,0,0,0,0,0,0,0,0,0,0,0,0,0,0
Medio_bajo,No_siniestro,90671,75,50.94,0,0,0,0,0,0,0,0,0,0,0,0,0,0,0
Medio_bajo,No_siniestro,91164,56,1013.6,0,0,0,0,0,0,0,0,0,0,0,0,0,0,0
Medio_bajo,No_siniestro,91642,45,2298.47,0,0,0,0,0,0,1,1,0,0,0,0,0,0,0
Medio_bajo,No_siniestro,91667,28,21212.17,54753.47,0,0,0,0,1,0,1,0,0,0,0,0,0,0
Medio_bajo,No_siniestro,92727,76,741.62,0,0,0,0,0,0,0,0,0,0,0,0,0,0,0
Medio_bajo,No_siniestro,93079,73,763.49,0,0,0,0,0,0,0,0,0,0,0,0,0,0,0
Medio_bajo,No_siniestro,93246,11,1254.68,0,0,0,0,0,0,0,0,0,0,0,0,0,0,0
Medio_bajo,No_siniestro,93960,39,11794.01,48368.56,0,0,0,0,0,1,1,0,0,0,0,0,0,0
Medio_bajo,No_siniestro,94143,63,0.11,47576.79,0,0,0,0,0,0,0,0,0,0,0,0,0,0
Medio_bajo,No_siniestro,94700,39,2272.71,0,0,0,0,0,0,0,0,0,0,0,0,0,0,0
Medio_bajo,No_siniestro,94972,7,6.06,0,0,0,0,0,0,0,0,0,0,0,0,0,0,0
Medio_bajo,No_siniestro,95401,111,1237.92,0,0,0,0,0,0,0,0,0,0,0,0,0,0,0
Medio_bajo,No_siniestro,95642,136,1799.25,0,1,0,0,1,0,0,2,0,0,0,0,0,0,0
Medio_bajo,No_siniestro,96216,37,1159.04,0,0,0,0,0,0,0,0,0,0,0,0,0,0,0
Medio_bajo,No_siniestro,96257,8,338.73,0,0,0,0,0,0,0,0,0,0,0,0,0,0,0
Medio_bajo,No_siniestro,96410,39,1386.62,0,0,0,0,0,0,0,0,0,0,0,0,0,0,0
Medio_bajo,No_siniestro,96497,41,10718.86,0,0,0,0,1,0,1,2,0,0,0,0,0,0,0
Medio_bajo,No_siniestro,96657,20,1739.14,0,0,0,0,0,0,0,0,0,0,0,0,0,0,0
Medio_bajo,No_siniestro,96782,85,1639.69,0,0,0,0,0,0,0,0,0,0,0,0,0,0,0
Medio_bajo,No_siniestro,98045,21,1838.2,0,0,0,0,0,0,0,0,0,0,0,0,0,0,0
Medio_bajo,No_siniestro,98266,75,2772.66,0,0,0,0,0,0,0,0,0,0,0,0,0,0,0
Medio_bajo,No_siniestro,98844,118,822.17,0,0,0,0,0,0,0,0,0,0,0,0,0,0,0
Medio_bajo,No_siniestro,99110,39,2273.38,148911.97,0,0,0,0,0,0,0,0,0,0,0,0,0,0
Medio_bajo,No_siniestro,100325,94,12341.71,0,0,0,0,0,0,0,0,0,0,0,0,0,0,0
Medio_bajo,No_siniestro,100481,103,6006.26,0,0,1,1,0,0,0,2,0,0,0,0,0,0,0
Medio_bajo,No_siniestro,100509,76,8950.9,0,0,0,0,0,0,0,0,0,0,0,0,0,0,0
Medio_bajo,No_siniestro,100955,71,3362.58,0,0,0,0,0,0,0,0,0,0,0,0,0,0,0
Medio_bajo,No_siniestro,101047,57,407.97,0,0,0,0,0,0,0,0,0,0,0,0,0,0,0
Medio_bajo,No_siniestro,101434,108,1460.87,0,0,0,0,0,0,0,0,0,0,0,0,0,0,0
Medio_bajo,No_siniestro,101775,34,630.64,49725.01,0,0,0,0,0,0,0,0,0,0,0,0,0,0
Medio_bajo,No_siniestro,102241,17,2.48,0,0,0,0,0,0,0,0,0,0,0,0,0,0,0
Medio_bajo,No_siniestro,102275,81,1234.18,0,0,0,0,0,0,0,0,0,0,0,0,0,0,0
Medio_bajo,No_siniestro,102303,52,3185.47,0,0,0,0,0,0,0,0,0,0,0,0,0,0,0
Medio_bajo,No_siniestro,102590,39,6457.75,0,0,0,0,0,0,0,0,0,0,0,0,0,0,0
Medio_bajo,No_siniestro,102860,39,1490.1,0,0,0,0,0,0,0,0,0,0,0,0,0,0,0
Medio_bajo,No_siniestro,104258,8,796.38,0,0,0,0,0,0,0,0,0,0,0,0,0,0,0
Medio_bajo,No_siniestro,104323,51,39,0,0,0,0,0,0,0,0,0,0,0,0,0,0,0
Medio_bajo,No_siniestro,104545,41,1163.68,0,0,0,0,0,0,0,0,0,0,0,0,0,0,0
Medio_bajo,No_siniestro,104566,43,0.01,72613.9,0,0,0,0,0,0,0,0,0,0,0,0,0,0
Medio_bajo,No_siniestro,104818,25,137.74,0,0,0,0,0,0,0,0,0,0,0,0,0,0,0
Medio_bajo,No_siniestro,105211,107,2439.31,0,0,0,0,0,0,0,0,0,0,0,0,0,0,0
Medio_bajo,No_siniestro,105859,61,192.46,0,0,0,0,0,1,0,1,0,0,0,0,0,0,0
Medio_bajo,No_siniestro,106058,57,3206.31,0,0,0,0,0,0,0,0,0,0,0,0,0,0,0
Medio_bajo,No_siniestro,106575,99,5853.2,0,0,0,0,0,0,0,0,0,0,0,0,0,0,0
Medio_bajo,No_siniestro,107554,55,5262.11,0,0,0,0,0,0,0,0,0,0,0,0,0,0,0
Medio_bajo,No_siniestro,107896,41,453.04,0,0,0,0,0,0,0,0,0,0,0,0,0,0,0
Medio_bajo,No_siniestro,108291,28,103.99,0,0,0,0,0,0,0,0,0,0,0,0,0,0,0
Medio_bajo,No_siniestro,108686,112,272.26,0,0,0,0,0,0,0,0,0,0,0,0,0,0,0
Medio_bajo,No_siniestro,108798,22,2124.49,0,0,0,0,0,0,0,0,0,0,0,0,0,0,0
Medio_bajo,No_siniestro,108849,118,15.99,0,1,0,0,0,0,0,1,0,0,0,0,0,0,0
Medio_bajo,No_siniestro,109166,56,1648.03,40694.84,0,0,0,0,0,0,0,0,0,0,0,0,0,0
Medio_bajo,No_siniestro,109341,62,9886.45,0,0,0,0,0,0,0,0,0,0,0,0,0,0,0
Medio_bajo,No_siniestro,110459,25,8092.31,0,0,0,0,0,0,0,0,0,0,0,0,0,0,0
Medio_bajo,No_siniestro,111287,47,3831.13,0,0,0,0,0,0,0,0,0,0,0,0,0,0,0
Medio_bajo,No_siniestro,111499,15,596.88,0,0,0,0,0,0,0,0,0,0,0,0,0,0,0
Medio_bajo,No_siniestro,111758,45,88.78,0,0,0,0,0,0,0,0,0,0,0,0,0,0,0
Medio_bajo,No_siniestro,112550,39,569.22,0,0,0,0,0,0,0,0,0,0,0,0,0,0,0
Medio_bajo,No_siniestro,112604,68,6224.63,0,1,1,0,0,1,1,4,0,0,0,0,0,0,0
Medio_bajo,No_siniestro,113047,44,4289.66,0,0,0,0,0,0,0,0,0,0,0,0,0,0,0
Medio_bajo,No_siniestro,114226,65,285.94,0,0,0,0,0,0,0,0,0,0,0,0,0,0,0
Medio_bajo,No_siniestro,114662,21,22058.59,0,0,0,1,0,0,0,1,0,0,0,0,0,0,0
Medio_bajo,No_siniestro,115389,11,263.19,0,0,0,0,0,0,0,0,0,0,0,0,0,0,0
Medio_bajo,No_siniestro,122130,39,48.02,0,0,0,0,0,0,0,0,0,0,0,0,0,0,0
Medio_bajo,No_siniestro,123655,10,7626.81,0,0,1,0,0,0,1,2,0,0,0,0,0,0,0
Medio_bajo,No_siniestro,124211,25,12.28,0,0,0,0,0,0,0,0,0,0,0,0,0,0,0
Medio_bajo,No_siniestro,124876,124,822.63,0,0,0,0,0,0,0,0,0,0,0,0,0,0,0
Medio_bajo,No_siniestro,125094,28,319.16,0,0,0,0,0,0,0,0,0,0,0,0,0,0,0
Medio_bajo,No_siniestro,125646,65,14486.84,0,0,0,0,0,0,0,0,0,0,0,0,0,0,0
Medio_bajo,No_siniestro,126119,23,4682.62,0,0,0,0,0,0,0,0,0,0,0,0,0,0,0
Medio_bajo,No_siniestro,126823,16,674.48,0,0,1,0,0,0,0,1,0,0,0,0,0,0,0
Medio_bajo,No_siniestro,127159,194,2814.44,0,0,0,0,0,0,0,0,0,0,0,0,0,0,0
Medio_bajo,No_siniestro,127437,108,5685.96,0,0,0,0,0,0,0,0,0,0,0,0,0,0,0
Medio_bajo,No_siniestro,128294,76,377.01,0,0,0,0,0,0,0,0,0,0,0,0,0,0,0
Medio_bajo,No_siniestro,128351,7,1308.01,0,0,0,0,0,1,0,1,0,0,0,0,0,0,0
Medio_bajo,No_siniestro,128636,61,3785.66,0,0,0,0,0,0,0,0,0,0,0,0,0,0,0
Medio_bajo,No_siniestro,128765,71,89.58,0,0,0,0,0,0,0,0,0,0,0,0,0,0,0
Medio_bajo,No_siniestro,129007,37,539.32,0,0,0,0,0,0,0,0,0,0,0,0,0,0,0
Medio_bajo,No_siniestro,129183,87,5967.92,0,0,0,0,0,0,0,0,0,0,0,0,0,0,0
Medio_bajo,No_siniestro,129546,11,4561,0,0,0,0,0,0,0,0,0,0,0,0,0,0,0
Medio_bajo,No_siniestro,130204,27,806.81,0,0,0,0,0,0,0,0,0,0,0,0,0,0,0
Medio_bajo,No_siniestro,130209,61,450.21,0,0,0,0,0,0,0,0,0,0,0,0,0,0,0
Medio_bajo,No_siniestro,130530,39,387.22,0,0,0,0,0,0,0,0,0,0,0,0,0,0,0
Medio_bajo,No_siniestro,130605,61,32835.84,85588.62,0,0,1,0,0,0,1,0,0,0,0,0,0,0
Medio_bajo,No_siniestro,130793,97,6000.74,0,0,0,0,0,0,0,0,0,0,0,0,0,0,0
Medio_bajo,No_siniestro,131036,6,1052.73,0,0,0,0,0,0,0,0,0,0,0,0,0,0,0
Medio_bajo,No_siniestro,131276,171,2844.65,0,1,1,0,0,0,1,3,0,0,0,0,0,0,0
Medio_bajo,No_siniestro,131331,12,3897.33,0,0,0,0,0,0,0,0,0,0,0,0,0,0,0
Medio_bajo,No_siniestro,131656,16,2332.71,0,0,0,0,0,0,0,0,0,0,0,0,0,0,0
Medio_bajo,No_siniestro,132672,57,11853.04,0,0,0,0,0,0,0,0,0,0,0,0,0,0,0
Medio_bajo,No_siniestro,132875,126,2332.09,0,0,0,0,0,0,0,0,0,0,0,0,0,0,0
Medio_bajo,No_siniestro,133001,217,16372.95,0,0,0,0,0,0,0,0,0,0,0,0,0,0,0
Medio_bajo,No_siniestro,133621,90,3911.54,0,0,0,0,0,0,0,0,0,0,0,0,0,0,0
Medio_bajo,No_siniestro,133809,98,11966.89,29267.3,0,0,0,0,0,0,0,0,0,0,0,0,0,0
Medio_bajo,No_siniestro,133836,81,195.24,0,0,0,0,0,0,0,0,0,0,0,0,0,0,0
Medio_bajo,No_siniestro,134426,24,15385.96,0,0,0,0,0,0,0,0,0,0,0,0,0,0,0
Medio_bajo,No_siniestro,134467,35,1987.18,32806.89,0,1,0,0,0,0,1,0,0,0,0,0,0,0
Medio_bajo,No_siniestro,135580,39,13738.99,0,0,0,0,0,0,0,0,0,0,0,0,0,0,0
Medio_bajo,No_siniestro,135692,61,283.07,0,0,0,0,0,0,0,0,0,0,0,0,0,0,0
Medio_bajo,No_siniestro,135930,39,310.51,0,0,0,0,0,0,0,0,0,0,0,0,0,0,0
Medio_bajo,No_siniestro,136592,106,726.61,0,0,0,0,0,0,1,1,0,0,0,0,0,0,0
Medio_bajo,No_siniestro,136775,52,44.33,0,0,1,0,0,0,0,1,0,0,0,0,0,0,0
Medio_bajo,No_siniestro,137062,9,5746.96,0,0,0,0,0,0,0,0,0,0,0,0,0,0,0
Medio_bajo,No_siniestro,137117,40,1040.84,0,0,0,0,0,0,0,0,0,0,0,0,0,0,0
Medio_bajo,No_siniestro,137213,37,595.25,0,0,0,0,1,0,0,1,0,0,0,0,0,0,0
Medio_bajo,No_siniestro,137489,106,1547.67,0,0,0,0,0,0,0,0,0,0,0,0,0,0,0
Medio_bajo,No_siniestro,137582,145,747.32,0,0,0,0,0,0,0,0,0,0,0,0,0,0,0
Medio_bajo,No_siniestro,137680,39,969.29,0,0,0,0,0,0,0,0,0,0,0,0,0,0,0
Medio_bajo,No_siniestro,137880,39,0.01,0,0,0,0,0,0,0,0,0,0,0,0,0,0,0
Medio_bajo,No_siniestro,137916,9,739.54,0,0,0,0,0,0,0,0,0,0,0,0,0,0,0
Medio_bajo,No_siniestro,137948,41,659.43,0,0,0,0,0,0,0,0,0,0,0,0,0,0,0
Medio_bajo,No_siniestro,137959,65,16443.78,0,0,0,0,0,0,0,0,0,0,0,0,0,0,0
Medio_bajo,No_siniestro,138144,49,120.49,0,0,0,0,0,0,0,0,0,0,0,0,0,0,0
Medio_bajo,No_siniestro,138175,68,5066.73,0,0,0,0,0,0,0,0,0,0,0,0,0,0,0
Medio_bajo,No_siniestro,138423,11,378.05,0,0,0,0,0,0,0,0,0,0,0,0,0,0,0
Medio_bajo,No_siniestro,138519,100,671.64,0,0,0,0,0,0,0,0,0,0,0,0,0,0,0
Medio_bajo,No_siniestro,139935,117,674.14,0,0,0,0,0,0,0,0,0,0,0,0,0,0,0
Medio_bajo,No_siniestro,141542,126,11810.7,4768.17,0,0,0,0,0,0,0,0,0,0,0,0,0,0
Medio_bajo,No_siniestro,142145,58,377.37,0,0,0,0,0,0,0,0,0,0,0,0,0,0,0
Medio_bajo,No_siniestro,142491,77,9045.25,0,0,0,0,0,0,0,0,0,0,0,0,0,0,0
Medio_bajo,No_siniestro,143237,62,1471.36,50577.37,0,0,0,0,0,0,0,0,0,0,0,0,0,0
Medio_bajo,No_siniestro,143535,130,0.44,0,0,0,0,0,0,0,0,0,0,0,0,0,0,0
Medio_bajo,No_siniestro,144894,28,397.3,0,0,0,0,0,0,0,0,0,0,0,0,0,0,0
Medio_bajo,No_siniestro,144912,23,21356.24,0,0,0,0,0,0,0,0,0,0,0,0,0,0,0
Medio_bajo,No_siniestro,145163,42,114.42,0,0,0,0,0,0,0,0,0,0,0,0,0,0,0
Medio_bajo,No_siniestro,145188,17,0.2,0,0,0,0,0,0,0,0,0,0,0,0,0,0,0
Medio_bajo,No_siniestro,145714,43,62.85,0,0,0,0,0,0,0,0,0,0,0,0,0,0,0
Medio_bajo,No_siniestro,145911,75,132.44,0,0,0,0,0,0,0,0,0,0,0,0,0,0,0
Medio_bajo,No_siniestro,146188,23,619.29,0,0,0,0,0,0,0,0,0,0,0,0,0,0,0
Medio_bajo,No_siniestro,146339,22,278.91,75201.32,0,0,0,0,0,0,0,0,0,0,0,0,0,0
Medio_bajo,Si_siniestro,146762,49,35272.21,0,1,0,0,0,0,0,1,0,0,0,0,0,0,0
Medio_bajo,No_siniestro,146783,131,8531,151588.37,0,0,0,0,0,0,0,0,0,0,0,0,0,0
Medio_bajo,No_siniestro,147103,104,1373.66,0,0,0,0,0,0,0,0,0,0,0,0,0,0,0
Medio_bajo,No_siniestro,147472,35,1974.46,0,0,0,0,0,0,0,0,0,0,0,0,0,0,0
Medio_bajo,No_siniestro,147651,70,2547.36,0,0,0,0,0,0,0,0,0,0,0,0,0,0,0
Medio_bajo,No_siniestro,147713,81,2068.74,0,0,0,0,0,0,0,0,0,0,0,0,0,0,0
Medio_bajo,No_siniestro,148530,39,4523.48,0,0,0,0,0,0,0,0,0,0,0,0,0,0,0
Medio_bajo,No_siniestro,148643,9,1958.32,0,0,0,0,0,0,0,0,0,0,0,0,0,0,0
Medio_bajo,No_siniestro,148725,7,1158.77,0,0,0,0,0,0,0,0,0,0,0,0,0,0,0
Medio_bajo,No_siniestro,148864,30,1710.69,0,0,0,0,0,0,0,0,0,0,0,0,0,0,0
Medio_bajo,No_siniestro,149000,39,1126.36,0,0,0,0,0,0,0,0,0,0,0,0,0,0,0
Medio_bajo,No_siniestro,149342,76,323.79,0,0,0,0,0,0,0,0,0,0,0,0,0,0,0
Medio_bajo,No_siniestro,149889,30,1094.09,0,0,0,0,0,0,0,0,0,0,0,0,0,0,0
Medio_bajo,No_siniestro,150068,56,4173.3,0,0,0,0,0,0,0,0,0,0,0,0,0,0,0
Medio_bajo,No_siniestro,150654,74,1609.97,0,0,0,0,0,0,0,0,0,0,0,0,0,0,0
Medio_bajo,No_siniestro,151013,110,337.89,0,0,0,0,0,0,0,0,0,0,0,0,0,0,0
Medio_bajo,No_siniestro,151693,13,3382.22,0,0,0,0,0,0,0,0,0,0,0,0,0,0,0
Medio_bajo,No_siniestro,151903,18,8784.45,0,0,0,0,0,0,0,0,0,0,0,0,0,0,0
Medio_bajo,No_siniestro,152067,44,8368.48,0,0,0,0,0,0,0,0,0,0,0,0,0,0,0
Medio_bajo,No_siniestro,152262,73,4514.88,0,0,0,0,0,0,0,0,0,0,0,0,0,0,0
Medio_bajo,No_siniestro,152290,39,0.62,0,0,0,0,0,0,0,0,0,0,0,0,0,0,0
Medio_bajo,No_siniestro,152321,62,278.29,0,0,0,0,0,0,0,0,0,0,0,0,0,0,0
Medio_bajo,No_siniestro,152860,39,4426.6,0,0,0,0,0,0,0,0,0,0,0,0,0,0,0
Medio_bajo,No_siniestro,153377,102,1146.84,0,0,0,0,0,0,0,0,0,0,0,0,0,0,0
Medio_bajo,No_siniestro,153486,32,834.78,0,0,0,0,0,0,0,0,0,0,0,0,0,0,0
Medio_bajo,No_siniestro,154776,47,1246.59,0,0,0,0,0,0,0,0,0,0,0,0,0,0,0
Medio_bajo,No_siniestro,155359,54,606.72,52946.44,0,0,0,0,0,0,0,0,0,0,0,0,0,0
Medio_bajo,No_siniestro,155571,8,5785.97,0,0,0,0,0,0,0,0,0,0,0,0,0,0,0
Medio_bajo,No_siniestro,155671,19,9948.58,0,0,0,0,0,0,0,0,0,0,0,0,0,0,0
Medio_bajo,No_siniestro,155832,83,686.54,0,0,0,0,0,0,0,0,0,0,0,0,0,0,0
Medio_bajo,No_siniestro,156457,120,2331.21,0,0,0,0,0,0,0,0,0,0,0,0,0,0,0
Medio_bajo,No_siniestro,156509,28,1054.61,0,0,0,0,0,0,0,0,0,0,0,0,0,0,0
Medio_bajo,No_siniestro,157350,39,3861.64,0,0,0,0,0,0,0,0,0,0,0,0,0,0,0
Medio_bajo,No_siniestro,157404,12,332.41,0,0,0,0,0,0,0,0,0,0,0,0,0,0,0
Medio_bajo,No_siniestro,159045,93,3316.55,0,0,0,0,0,0,0,0,0,0,0,0,0,0,0
Medio_bajo,No_siniestro,159836,22,8031.03,0,0,0,0,0,0,0,0,0,0,0,0,0,0,0
Medio_bajo,No_siniestro,160749,23,1711.87,0,0,0,0,0,0,0,0,0,0,0,0,0,0,0
Medio_bajo,No_siniestro,161404,150,4051.35,26064.66,0,0,0,0,0,0,0,0,0,0,0,0,0,0
Medio_bajo,No_siniestro,161448,75,441.76,0,0,0,0,0,0,0,0,0,0,0,0,0,0,0
Medio_bajo,No_siniestro,162941,43,1463.21,0,0,0,0,0,0,0,0,0,0,0,0,0,0,0
Medio_bajo,Si_siniestro,162992,36,0.4,0,3,2,1,0,0,0,6,0,0,0,0,0,0,0
Medio_bajo,No_siniestro,164108,103,583.9,0,0,0,0,0,0,0,0,0,0,0,0,0,0,0
Medio_bajo,No_siniestro,164334,37,17.82,0,0,0,0,0,0,0,0,0,0,0,0,0,0,0
Medio_bajo,No_siniestro,164360,49,9502.58,0,1,1,1,1,1,0,5,0,0,0,0,0,0,0
Medio_bajo,No_siniestro,164597,6,18217.05,29336.39,0,0,0,0,0,0,0,0,0,0,0,0,0,0
Medio_bajo,No_siniestro,164687,9,15526.9,0,0,0,0,0,0,0,0,0,0,0,0,0,0,0
Medio_bajo,No_siniestro,165590,49,95.94,0,0,0,0,0,0,0,0,0,0,0,0,0,0,0
Medio_bajo,No_siniestro,165896,19,7535.62,0,0,0,0,0,0,0,0,0,0,0,0,0,0,0
Medio_bajo,No_siniestro,166064,8,61.47,0,0,0,0,0,0,0,0,0,0,0,0,0,0,0
Medio_bajo,No_siniestro,166181,7,3938.97,0,0,0,0,0,0,0,0,0,0,0,0,0,0,0
Medio_bajo,No_siniestro,166365,85,5274.93,0,0,0,0,0,0,0,0,0,0,0,0,0,0,0
Medio_bajo,No_siniestro,166657,85,0.01,0,0,0,0,0,0,0,0,0,0,0,0,0,0,0
Medio_bajo,No_siniestro,167311,27,8542.03,0,0,0,0,0,0,0,0,0,0,0,0,0,0,0
Medio_bajo,No_siniestro,167314,58,3456.75,0,1,0,0,0,0,0,1,0,0,0,0,0,0,0
Medio_bajo,No_siniestro,168860,49,8199.18,0,0,0,0,0,0,0,0,0,0,0,0,0,0,0
Medio_bajo,No_siniestro,168997,9,31.42,0,0,0,0,1,0,0,1,0,0,0,0,0,0,0
Medio_bajo,No_siniestro,169992,150,1203,0,0,0,0,0,0,0,0,0,0,0,0,0,0,0
Medio_bajo,No_siniestro,170767,20,1020.71,0,0,0,0,0,0,0,0,0,0,0,0,0,0,0
Medio_bajo,No_siniestro,170982,71,1058.73,42186.17,0,0,0,0,0,0,0,0,0,0,0,0,0,0
Medio_bajo,No_siniestro,171213,24,3073.72,0,0,0,0,0,0,0,0,0,0,0,0,0,0,0
Medio_bajo,No_siniestro,171235,13,22304.65,0,0,0,0,0,0,0,0,0,0,0,0,0,0,0
Medio_bajo,No_siniestro,171452,18,1999.88,0,0,0,0,0,0,0,0,0,0,0,0,0,0,0
Medio_bajo,No_siniestro,171831,24,6702.01,0,0,0,0,0,0,0,0,0,0,0,0,0,0,0
Medio_bajo,No_siniestro,172424,109,276.48,0,0,0,0,0,1,0,1,0,0,0,0,0,0,0
Medio_bajo,No_siniestro,172453,92,1217.83,0,0,0,0,0,0,0,0,0,0,0,0,0,0,0
Medio_bajo,No_siniestro,173219,86,100.41,0,0,0,0,0,0,0,0,0,0,0,0,0,0,0
Medio_bajo,Si_siniestro,173298,90,1004.04,0,0,0,0,0,0,0,0,0,0,0,0,0,0,0
Medio_bajo,No_siniestro,174007,43,36.12,0,0,0,0,0,0,0,0,0,0,0,0,0,0,0
Medio_bajo,No_siniestro,174010,49,2492.51,0,0,0,0,0,0,0,0,0,0,0,0,0,0,0
Medio_bajo,No_siniestro,174095,24,1.21,0,0,0,0,0,0,0,0,0,0,0,0,0,0,0
Medio_bajo,No_siniestro,174469,23,1351.9,0,0,0,0,0,0,0,0,0,0,0,0,0,0,0
Medio_bajo,No_siniestro,174506,78,1836.74,52131.94,0,0,0,0,0,0,0,0,0,0,0,0,0,0
Medio_bajo,No_siniestro,174684,28,609.27,0,0,0,0,0,0,0,0,0,0,0,0,0,0,0
Medio_bajo,No_siniestro,174854,105,824.37,0,0,0,0,0,0,0,0,0,0,0,0,0,0,0
Medio_bajo,No_siniestro,174956,7,273.19,0,0,0,0,0,0,0,0,0,0,0,0,0,0,0
Medio_bajo,No_siniestro,175987,37,1449.61,0,0,0,0,0,0,0,0,0,0,0,0,0,0,0
Medio_bajo,No_siniestro,176430,49,4647.57,0,0,0,0,0,0,0,0,0,0,0,0,0,0,0
Medio_bajo,No_siniestro,176697,60,6535.95,0,0,0,0,0,0,0,0,0,0,0,0,0,0,0
Medio_bajo,No_siniestro,176720,49,4740.09,0,0,0,0,0,0,0,0,0,0,0,0,0,0,0
Medio_bajo,No_siniestro,178236,51,24.56,0,0,0,0,0,0,0,0,0,0,0,0,0,0,0
Medio_bajo,Si_siniestro,179239,11,119.48,0,1,0,1,0,1,0,3,0,0,0,0,0,0,0
Medio_bajo,No_siniestro,179989,52,5018.01,0,0,0,0,0,0,0,0,0,0,0,0,0,0,0
Medio_bajo,No_siniestro,180202,29,320.55,0,0,0,0,0,0,0,0,0,0,0,0,0,0,0
Medio_bajo,No_siniestro,180317,26,3185.2,0,0,0,0,0,0,0,0,0,0,0,0,0,0,0
Medio_bajo,No_siniestro,186171,29,1557.92,0,0,0,0,0,0,0,0,0,0,0,0,0,0,0
Medio_bajo,No_siniestro,188031,40,1181.27,0,0,0,0,0,0,0,0,0,0,0,0,0,0,0
Medio_bajo,No_siniestro,188482,146,546.19,0,0,0,0,0,0,0,0,0,0,0,0,0,0,0
Medio_bajo,No_siniestro,188658,53,971.32,0,1,1,0,1,1,1,5,0,0,0,0,0,0,0
Medio_bajo,No_siniestro,188702,45,184.26,0,0,0,0,0,0,0,0,0,0,0,0,0,0,0
Medio_bajo,No_siniestro,188936,8,24.59,0,0,0,0,0,0,0,0,0,0,0,0,0,0,0
Medio_bajo,No_siniestro,189193,51,8174.27,0,0,0,0,0,0,0,0,0,0,0,0,0,0,0
Medio_bajo,No_siniestro,189282,90,10031.58,0,0,0,0,0,0,0,0,0,0,0,0,0,0,0
Medio_bajo,No_siniestro,189832,113,806.7,0,0,0,0,0,1,0,1,0,0,0,0,0,0,0
Medio_bajo,No_siniestro,191020,49,1035.52,0,0,0,1,0,1,0,2,0,0,0,0,0,0,0
Medio_bajo,No_siniestro,191029,84,2355.61,0,0,0,0,0,0,0,0,0,0,0,0,0,0,0
Medio_bajo,No_siniestro,191043,31,4436.34,0,0,0,0,0,0,0,0,0,0,0,0,0,0,0
Medio_bajo,No_siniestro,191316,186,0.02,0,0,0,0,0,0,0,0,0,0,0,0,0,0,0
Medio_bajo,No_siniestro,192399,19,390.6,0,0,0,0,0,0,0,0,0,0,0,0,0,0,0
Medio_bajo,No_siniestro,192649,98,546.63,0,0,0,0,0,1,0,1,0,0,0,0,0,0,0
Medio_bajo,No_siniestro,192906,65,0.02,0,0,0,0,0,0,0,0,0,0,0,0,0,0,0
Medio_bajo,No_siniestro,193121,26,4287.34,0,0,0,0,0,0,0,0,0,0,0,0,0,0,0
Medio_bajo,No_siniestro,193169,205,7009.64,0,0,0,0,0,0,0,0,0,0,0,0,0,0,0
Medio_bajo,No_siniestro,193269,46,2410.35,0,0,0,0,0,0,0,0,0,0,0,0,0,0,0
Medio_bajo,No_siniestro,193691,23,591.9,0,0,0,0,0,0,0,0,0,0,0,0,0,0,0
Medio_bajo,No_siniestro,193757,77,7366.17,0,0,0,0,0,1,0,1,0,0,0,0,0,0,0
Medio_bajo,No_siniestro,193850,49,6451.46,0,0,0,0,0,0,0,0,0,0,0,0,0,0,0
Medio_bajo,No_siniestro,193917,13,1138.61,4998.98,0,0,0,0,0,0,0,0,0,0,0,0,0,0
Medio_bajo,No_siniestro,194283,10,306.1,0,1,0,0,0,0,0,1,0,0,0,0,0,0,0
Medio_bajo,No_siniestro,194380,49,4133.89,40724.3,0,0,0,0,0,0,0,0,0,0,0,0,0,0
Medio_bajo,No_siniestro,195136,64,649.2,0,0,0,0,0,0,0,0,0,0,0,0,0,0,0
Medio_bajo,No_siniestro,195167,27,16.32,0,0,0,0,0,0,0,0,0,0,0,0,0,0,0
Medio_bajo,No_siniestro,195415,35,770.46,0,0,0,0,0,1,0,1,0,0,0,0,0,0,0
Medio_bajo,No_siniestro,196081,6,582.39,0,0,0,0,0,1,0,1,0,0,0,0,0,0,0
Medio_bajo,Si_siniestro,196517,20,2065.59,0,0,0,0,0,0,0,0,0,0,0,0,0,0,0
Medio_bajo,No_siniestro,197036,183,423.52,0,0,3,2,1,0,1,7,0,0,0,0,0,0,0
Medio_bajo,No_siniestro,197075,43,907.01,0,0,0,0,0,0,0,0,0,0,0,0,0,0,0
Medio_bajo,No_siniestro,197534,179,1759.32,0,0,0,0,0,0,0,0,0,0,0,0,0,0,0
Medio_bajo,No_siniestro,197589,54,2397.34,194145.78,0,0,0,0,0,0,0,0,0,0,0,0,0,0
Medio_bajo,No_siniestro,197667,59,735.63,0,0,0,0,0,0,0,0,0,0,0,0,0,0,0
Medio_bajo,Si_siniestro,197743,112,6738.92,0,0,0,0,0,0,0,0,0,0,0,0,0,0,0
Medio_bajo,No_siniestro,198094,53,42.18,0,0,0,0,0,0,0,0,0,0,0,0,0,0,0
Medio_bajo,No_siniestro,198412,10,3.95,0,0,0,0,0,0,0,0,0,0,0,0,0,0,0
Medio_bajo,No_siniestro,198457,45,708.63,27186.46,0,0,0,0,0,0,0,0,0,0,0,0,0,0
Medio_bajo,No_siniestro,198712,86,5898.19,27209.56,0,0,0,0,0,0,0,0,0,0,0,0,0,0
Medio_bajo,No_siniestro,198833,113,5461.81,0,0,0,0,0,0,0,0,0,0,0,0,0,0,0
Medio_bajo,No_siniestro,198903,88,284.28,0,0,0,0,0,0,0,0,0,0,0,0,0,0,0
Medio_bajo,No_siniestro,199254,84,2552.62,0,0,0,0,0,0,0,0,0,0,0,0,0,0,0
Medio_bajo,No_siniestro,199277,164,4.94,0,0,0,0,0,0,0,0,0,0,0,0,0,0,0
Medio_bajo,No_siniestro,199304,109,1328.89,0,0,0,0,0,0,1,1,0,0,0,0,0,0,0
Medio_bajo,No_siniestro,199344,107,471.61,0,0,0,0,0,0,0,0,0,0,0,0,0,0,0
Medio_bajo,No_siniestro,199434,54,353.99,0,0,0,0,0,0,0,0,0,0,0,0,0,0,0
Medio_bajo,No_siniestro,199695,41,403.87,0,0,0,0,0,0,0,0,0,0,0,0,0,0,0
Medio_bajo,No_siniestro,199952,56,1106.94,0,0,0,0,0,0,0,0,0,0,0,0,0,0,0
Medio_bajo,No_siniestro,200446,97,904.73,39602.78,0,0,0,0,0,0,0,0,0,0,0,0,0,0
Medio_bajo,No_siniestro,200820,49,899.03,0,0,2,1,2,1,0,6,0,0,0,0,0,0,0
Medio_bajo,No_siniestro,201743,77,19588.92,0,0,0,0,0,0,0,0,0,0,0,0,0,0,0
Medio_bajo,No_siniestro,201886,84,9391.72,0,0,0,0,0,0,0,0,0,0,0,0,0,0,0
Medio_bajo,No_siniestro,202665,58,383.02,0,0,0,0,0,0,0,0,0,0,0,0,0,0,0
Medio_bajo,No_siniestro,202735,18,6701.34,0,0,0,0,0,0,0,0,0,0,0,0,0,0,0
Medio_bajo,No_siniestro,203015,63,259.32,0,0,0,0,0,0,0,0,0,0,0,0,0,0,0
Medio_bajo,No_siniestro,203034,10,1783.81,0,0,1,0,0,1,1,3,0,0,0,0,0,0,0
Medio_bajo,No_siniestro,204640,49,1772.19,0,0,0,0,0,0,0,0,0,0,0,0,0,0,0
Medio_bajo,No_siniestro,204684,77,37267.81,0,0,0,0,0,0,0,0,0,0,0,0,0,0,0
Medio_bajo,No_siniestro,204694,112,223.85,0,0,0,0,0,0,0,0,0,0,0,0,0,0,0
Medio_bajo,No_siniestro,205305,103,2098.52,0,0,0,0,0,0,0,0,0,0,0,0,0,0,0
Medio_bajo,No_siniestro,205635,43,5980.63,0,0,0,0,0,0,1,1,0,0,0,0,0,0,0
Medio_bajo,No_siniestro,205647,171,717.03,0,0,0,0,0,0,0,0,0,0,0,0,0,0,0
Medio_bajo,No_siniestro,205774,18,12418.76,0,0,0,0,0,0,0,0,0,0,0,0,0,0,0
Medio_bajo,No_siniestro,206227,95,19.32,44478.4,1,0,0,0,0,0,1,0,0,0,0,0,0,0
Medio_bajo,Si_siniestro,206387,191,3179.27,0,2,1,0,0,2,1,6,0,0,0,0,0,0,0
Medio_bajo,No_siniestro,207801,10,2185.18,0,0,0,0,0,0,0,0,0,0,0,0,0,0,0
Medio_bajo,No_siniestro,208780,49,1243.73,0,0,0,0,0,0,0,0,0,0,0,0,0,0,0
Medio_bajo,No_siniestro,209085,6,7128.7,0,0,0,0,0,0,0,0,0,0,0,0,0,0,0
Medio_bajo,No_siniestro,209689,45,5514.32,0,0,0,0,0,0,0,0,0,0,0,0,0,0,0
Medio_bajo,No_siniestro,210268,71,24189.84,46092.7,0,0,0,0,0,0,0,0,0,0,0,0,0,0
Medio_bajo,No_siniestro,211071,82,714.07,0,0,1,0,0,0,0,1,0,0,0,0,0,0,0
Medio_bajo,No_siniestro,211231,15,962.33,0,0,0,0,0,0,0,0,0,0,0,0,0,0,0
Medio_bajo,No_siniestro,211285,44,45.82,0,0,0,0,0,0,0,0,0,0,0,0,0,0,0
Medio_bajo,No_siniestro,211346,26,7458.83,7795.91,0,0,0,0,0,0,0,0,0,0,0,0,0,0
Medio_bajo,No_siniestro,212064,122,228.56,0,0,0,0,0,0,0,0,0,0,0,0,0,0,0
Medio_bajo,No_siniestro,212614,33,1692.05,0,0,0,0,0,0,0,0,0,0,0,0,0,0,0
Medio_bajo,No_siniestro,212945,22,904.63,0,0,0,0,0,0,0,0,0,0,0,0,0,0,0
Medio_bajo,No_siniestro,213780,49,973.74,0,0,0,0,0,0,0,0,0,0,0,0,0,0,0
Medio_bajo,No_siniestro,214073,64,6278.63,0,0,0,0,0,0,0,0,0,0,0,0,0,0,0
Medio_bajo,No_siniestro,214225,44,1099.36,0,0,0,0,0,0,1,1,0,0,0,0,0,0,0
Medio_bajo,No_siniestro,214294,7,2720.42,0,0,0,0,0,0,0,0,0,0,0,0,0,0,0
Medio_bajo,No_siniestro,214545,42,12305.41,46147.92,0,0,0,0,0,0,0,0,0,0,0,0,0,0
Medio_bajo,No_siniestro,214640,49,518.97,71798.94,0,0,0,0,0,0,0,0,0,0,0,0,0,0
Medio_bajo,No_siniestro,214988,23,6876.62,0,0,0,0,0,0,0,0,0,0,0,0,0,0,0
Medio_bajo,No_siniestro,215120,49,342.04,0,1,1,0,1,1,7,11,0,0,0,0,0,0,0
Medio_bajo,No_siniestro,216311,196,95.13,0,0,0,0,0,0,0,0,0,0,0,0,0,0,0
Medio_bajo,No_siniestro,217069,6,1041.71,0,0,0,0,0,0,0,0,0,0,0,0,0,0,0
Medio_bajo,No_siniestro,217184,65,9224.34,0,0,0,0,0,0,0,0,0,0,0,0,0,0,0
Medio_bajo,No_siniestro,217261,15,5730.38,0,0,0,0,0,0,0,0,0,0,0,0,0,0,0
Medio_bajo,No_siniestro,217285,63,6313.72,0,0,0,0,0,0,1,1,0,0,0,0,0,0,0
Medio_bajo,No_siniestro,217704,12,201.19,0,0,0,0,0,0,0,0,0,0,0,0,0,0,0
Medio_bajo,No_siniestro,218168,76,16391.19,0,0,0,0,0,0,0,0,0,0,0,0,0,0,0
Medio_bajo,No_siniestro,219251,22,124.36,0,0,0,0,0,0,0,0,0,0,0,0,0,0,0
Medio_bajo,No_siniestro,220174,32,2814.2,0,0,0,0,0,0,0,0,0,0,0,0,0,0,0
Medio_bajo,No_siniestro,220227,54,537.71,0,0,0,0,0,0,0,0,0,0,0,0,0,0,0
Medio_bajo,No_siniestro,220306,44,3815.13,0,0,0,0,0,0,0,0,0,0,0,0,0,0,0
Medio_bajo,No_siniestro,220308,53,5564.23,0,0,0,0,0,0,0,0,0,0,0,0,0,0,0
Medio_bajo,No_siniestro,220617,71,19805.94,0,0,0,0,0,0,0,0,0,0,0,0,0,0,0
Medio_bajo,No_siniestro,221964,181,171.08,0,0,0,0,0,0,0,0,0,0,0,0,0,0,0
Medio_bajo,No_siniestro,222441,51,3.95,0,0,0,0,0,0,0,0,0,0,0,0,0,0,0
Medio_bajo,No_siniestro,222960,49,838.99,0,0,0,0,0,0,0,0,0,0,0,0,0,0,0
Medio_bajo,No_siniestro,223138,73,2325.77,0,0,0,0,0,0,0,0,0,0,0,0,0,0,0
Medio_bajo,No_siniestro,223165,57,305.33,0,0,0,0,0,0,0,0,0,0,0,0,0,0,0
Medio_bajo,No_siniestro,223259,51,41.2,0,0,0,0,0,0,0,0,0,0,0,0,0,0,0
Medio_bajo,No_siniestro,223347,68,47.45,0,0,0,0,0,0,0,0,0,0,0,0,0,0,0
Medio_bajo,Si_siniestro,223405,48,959.37,0,0,0,0,0,0,0,0,0,0,0,0,0,0,0
Medio_bajo,No_siniestro,224452,20,23.14,0,0,0,0,0,0,0,0,0,0,0,0,0,0,0
Medio_bajo,Si_siniestro,224697,34,5425.91,0,0,0,0,0,0,1,1,0,0,0,0,0,0,0
Medio_bajo,No_siniestro,225456,151,26.52,0,0,0,0,0,0,0,0,0,0,0,0,0,0,0
Medio_bajo,No_siniestro,226094,78,186.96,0,0,0,0,0,0,0,0,0,0,0,0,0,0,0
Medio_bajo,No_siniestro,226407,35,173.31,67621.39,0,0,0,0,0,0,0,0,0,0,0,0,0,0
Medio_bajo,No_siniestro,226455,25,11309.81,0,0,0,0,0,0,0,0,0,0,0,0,0,0,0
Medio_bajo,No_siniestro,226841,35,516.79,77672.26,0,0,0,0,0,0,0,0,0,0,0,0,0,0
Medio_bajo,No_siniestro,227059,37,13761.7,0,0,0,0,1,0,0,1,0,0,0,0,0,0,0
Medio_bajo,No_siniestro,228580,49,751.95,0,0,0,0,0,0,0,0,0,0,0,0,0,0,0
Medio_bajo,No_siniestro,229341,58,2833.17,0,0,0,0,0,0,0,0,0,0,0,0,0,0,0
Medio_bajo,No_siniestro,229724,41,1335.84,0,0,0,0,0,0,0,0,0,0,0,0,0,0,0
Medio_bajo,No_siniestro,230038,41,6666.04,127121.28,0,0,0,0,0,0,0,0,0,0,0,0,0,0
Medio_bajo,No_siniestro,230051,23,138.44,0,0,0,0,0,0,0,0,0,0,0,0,0,0,0
Medio_bajo,No_siniestro,230912,38,5.71,0,0,0,0,0,0,0,0,0,0,0,0,0,0,0
Medio_bajo,No_siniestro,230944,12,100.15,0,0,0,0,0,0,0,0,0,0,0,0,0,0,0
Medio_bajo,Si_siniestro,233262,33,12.58,0,0,0,0,0,0,0,0,0,0,0,0,0,0,0
Medio_bajo,No_siniestro,233407,13,442.28,0,0,0,0,0,0,0,0,0,0,0,0,0,0,0
Medio_bajo,No_siniestro,234084,40,139.75,0,0,0,0,0,0,0,0,0,0,0,0,0,0,0
Medio_bajo,No_siniestro,235153,86,1844.77,0,0,0,0,0,0,0,0,0,0,0,0,0,0,0
Medio_bajo,No_siniestro,237145,74,1642.35,0,0,0,0,0,0,0,0,0,0,0,0,0,0,0
Medio_bajo,No_siniestro,238243,85,828.45,0,0,0,0,0,0,0,0,0,0,0,0,0,0,0
Medio_bajo,No_siniestro,238663,78,738.17,0,0,0,0,0,0,0,0,0,0,0,0,0,0,0
Medio_bajo,No_siniestro,239125,9,3785.86,0,0,0,0,0,0,0,0,0,0,0,0,0,0,0
Medio_bajo,No_siniestro,239527,52,152.45,0,0,0,1,0,0,0,1,0,0,0,0,0,0,0
Medio_bajo,No_siniestro,239663,41,6429.61,0,0,0,0,0,0,0,0,0,0,0,0,0,0,0
Medio_bajo,No_siniestro,240063,76,887.78,0,0,1,0,0,0,0,1,0,0,0,0,0,0,0
Medio_bajo,No_siniestro,240669,49,1003.49,0,0,0,0,0,0,0,0,0,0,0,0,0,0,0
Medio_bajo,No_siniestro,241014,48,568.16,0,0,0,0,0,0,0,0,0,0,0,0,0,0,0
Medio_bajo,No_siniestro,241109,75,106.52,0,0,0,0,0,0,0,0,0,0,0,0,0,0,0
Medio_bajo,No_siniestro,242170,49,254.39,0,0,0,0,0,0,0,0,0,0,0,0,0,0,0
Medio_bajo,No_siniestro,242607,8,1241.69,0,0,0,0,0,0,0,0,0,0,0,0,0,0,0
Medio_bajo,No_siniestro,243039,35,1161.2,0,1,0,0,0,0,0,1,0,0,0,0,0,0,0
Medio_bajo,No_siniestro,244623,82,558.83,0,0,0,0,0,0,0,0,0,0,0,0,0,0,0
Medio_bajo,No_siniestro,244733,7,227.71,0,0,0,0,0,0,0,0,0,0,0,0,0,0,0
Medio_bajo,No_siniestro,248665,56,202.69,0,0,0,0,0,0,0,0,0,0,0,0,0,0,0
Medio_bajo,No_siniestro,251869,77,1843.14,0,0,0,0,0,0,0,0,0,0,0,0,0,0,0
Medio_bajo,No_siniestro,252229,102,336.37,0,0,0,0,0,0,0,0,0,0,0,0,0,0,0
Medio_bajo,No_siniestro,252250,49,2218.39,0,0,0,0,0,0,0,0,0,0,0,0,0,0,0
Medio_bajo,No_siniestro,252310,49,1157.18,0,0,0,0,0,0,0,0,0,0,0,0,0,0,0
Medio_bajo,No_siniestro,252761,146,76.89,82476.96,0,0,0,0,0,0,0,0,0,0,0,0,0,0
Medio_bajo,No_siniestro,252890,49,402.74,0,0,1,0,0,0,0,1,0,0,0,0,0,0,0
Medio_bajo,No_siniestro,254465,49,2249.07,0,0,0,0,0,0,0,0,0,0,0,0,0,0,0
Medio_bajo,No_siniestro,254778,101,9472.83,0,0,0,0,0,0,0,0,0,0,0,0,0,0,0
Medio_bajo,No_siniestro,254802,57,1416.87,0,0,0,0,0,0,0,0,0,0,0,0,0,0,0
Medio_bajo,No_siniestro,255335,31,1038.71,0,0,0,0,0,0,0,0,0,0,0,0,0,0,0
Medio_bajo,No_siniestro,256439,87,5924.01,0,0,0,0,0,0,0,0,0,0,0,0,0,0,0
Medio_bajo,No_siniestro,256516,158,1988.73,0,0,0,0,0,0,0,0,0,0,0,0,0,0,0
Medio_bajo,No_siniestro,256748,194,1842,0,0,0,0,0,0,0,0,0,0,0,0,0,0,0
Medio_bajo,No_siniestro,258199,27,0.08,0,0,0,0,0,0,0,0,0,0,0,0,0,0,0
Medio_bajo,No_siniestro,258424,96,0.01,0,0,0,0,0,0,0,0,0,0,0,0,0,0,0
Medio_bajo,No_siniestro,258776,37,587.92,0,0,0,0,0,0,0,0,0,0,0,0,0,0,0
Medio_bajo,No_siniestro,259791,80,150.85,0,0,0,0,0,0,0,0,0,0,0,0,0,0,0
Medio_bajo,No_siniestro,259868,75,1239.24,0,0,0,0,0,0,0,0,0,0,0,0,0,0,0
Medio_bajo,No_siniestro,260725,6,575.12,0,0,0,0,0,0,0,0,0,0,0,0,0,0,0
Medio_bajo,No_siniestro,261546,41,8169.36,0,0,0,0,0,0,0,0,0,0,0,0,0,0,0
Medio_bajo,No_siniestro,261724,128,445.5,0,0,0,0,0,0,0,0,0,0,0,0,0,0,0
Medio_bajo,No_siniestro,261729,42,6178.8,0,0,0,0,0,0,0,0,0,0,0,0,0,0,0
Medio_bajo,No_siniestro,261928,75,809.83,0,0,0,0,0,0,0,0,0,0,0,0,0,0,0
Medio_bajo,Si_siniestro,262032,58,14489.46,0,0,0,0,1,0,0,1,0,0,0,0,0,0,0
Medio_bajo,No_siniestro,262300,49,2903.12,0,0,0,0,0,0,0,0,0,0,0,0,0,0,0
Medio_bajo,Si_siniestro,262334,39,18286.06,0,0,0,0,0,0,0,0,0,0,0,0,0,0,0
Medio_bajo,No_siniestro,262647,9,4084.87,0,0,0,0,0,0,0,0,0,0,0,0,0,0,0
Medio_bajo,No_siniestro,262901,44,680.42,0,0,0,0,0,0,0,0,0,0,0,0,0,0,0
Medio_bajo,No_siniestro,262908,75,284.92,25748.7,0,0,0,0,0,0,0,0,0,0,0,0,0,0
Medio_bajo,No_siniestro,263099,75,13318.17,0,0,0,0,0,0,1,1,0,0,0,0,0,0,0
Medio_bajo,No_siniestro,263163,114,6290.8,33238.45,0,0,0,0,0,0,0,0,0,0,0,0,0,0
Medio_bajo,No_siniestro,263565,62,543.53,0,0,0,0,0,0,0,0,0,0,0,0,0,0,0
Medio_bajo,No_siniestro,263982,113,25013.99,0,0,0,0,0,1,0,1,0,0,0,0,0,0,0
Medio_bajo,No_siniestro,264235,46,1443.85,0,0,1,0,2,1,0,4,0,0,0,0,0,0,0
Medio_bajo,No_siniestro,264551,76,486.15,0,0,0,0,0,0,0,0,0,0,0,0,0,0,0
Medio_bajo,No_siniestro,265386,99,450.01,0,0,0,0,0,0,0,0,0,0,0,0,0,0,0
Medio_bajo,Si_siniestro,265545,9,707.41,0,0,0,0,0,0,0,0,0,0,0,0,0,0,0
Medio_bajo,No_siniestro,267271,26,8199.12,0,0,0,0,0,0,0,0,0,0,0,0,0,0,0
Medio_bajo,No_siniestro,267331,130,4835.06,0,0,0,0,0,0,0,0,0,0,0,0,0,0,0
Medio_bajo,No_siniestro,268161,107,1716.75,0,0,0,1,0,0,0,1,0,0,0,0,0,0,0
Medio_bajo,No_siniestro,268407,84,117.7,7602.86,0,0,0,0,0,0,0,0,0,0,0,0,0,0
Medio_bajo,No_siniestro,268853,173,4364.18,0,0,0,0,0,0,0,0,0,0,0,0,0,0,0
Medio_bajo,No_siniestro,269013,45,2064.75,0,0,0,0,0,0,0,0,0,0,0,0,0,0,0
Medio_bajo,No_siniestro,269066,80,508.11,0,0,0,0,0,0,0,0,0,0,0,0,0,0,0
Medio_bajo,No_siniestro,269435,40,738.8,0,0,0,0,0,0,0,0,0,0,0,0,0,0,0
Medio_bajo,No_siniestro,269445,47,1114.17,0,0,0,0,0,0,0,0,0,0,0,0,0,0,0
Medio_bajo,No_siniestro,269577,41,439.56,0,0,0,0,0,0,0,0,0,0,0,0,0,0,0
Medio_bajo,No_siniestro,270028,164,9274.28,0,0,0,0,0,0,0,0,0,0,0,0,0,0,0
Medio_bajo,No_siniestro,270393,61,8658.56,0,0,0,0,0,0,0,0,0,0,0,0,0,0,0
Medio_bajo,No_siniestro,270897,56,15041.37,0,0,0,0,0,0,0,0,0,0,0,0,0,0,0
Medio_bajo,No_siniestro,271163,71,605.38,95345.5,0,0,0,0,0,0,0,0,0,0,0,0,0,0
Medio_bajo,No_siniestro,271345,149,779.53,0,0,0,0,0,0,0,0,0,0,0,0,0,0,0
Medio_bajo,No_siniestro,271528,132,1053.38,0,0,0,0,0,0,0,0,0,0,0,0,0,0,0
Medio_bajo,No_siniestro,271701,16,2232.09,0,0,0,0,0,0,0,0,0,0,0,0,0,0,0
Medio_bajo,No_siniestro,271809,12,616.21,0,0,0,0,0,0,0,0,0,0,0,0,0,0,0
Medio_bajo,No_siniestro,272234,78,1527.83,0,0,0,0,0,0,0,0,0,0,0,0,0,0,0
Medio_bajo,No_siniestro,273029,31,3125.36,0,0,0,0,0,0,0,0,0,0,0,0,0,0,0
Medio_bajo,No_siniestro,273399,10,1649.97,0,0,0,0,0,0,0,0,0,0,0,0,0,0,0
Medio_bajo,No_siniestro,274641,177,9513.59,0,0,0,0,0,0,0,0,0,0,0,0,0,0,0
Medio_bajo,No_siniestro,274805,47,2603.79,0,0,0,0,0,0,0,0,0,0,0,0,0,0,0
Medio_bajo,Si_siniestro,274827,42,656.53,0,0,0,0,0,0,0,0,0,0,0,0,0,0,0
Medio_bajo,No_siniestro,274910,49,107.2,0,0,0,0,0,0,0,0,0,0,0,0,0,0,0
Medio_bajo,No_siniestro,275683,85,1.1,0,0,0,0,0,0,0,0,0,0,0,0,0,0,0
Medio_bajo,No_siniestro,275947,91,21702.88,0,0,0,3,2,1,0,6,0,0,0,0,0,0,0
Medio_bajo,No_siniestro,276817,76,370.9,0,0,0,0,0,0,0,0,0,0,0,0,0,0,0
Medio_bajo,No_siniestro,277217,127,5628.29,0,0,0,0,0,0,0,0,0,0,0,0,0,0,0
Medio_bajo,No_siniestro,277531,30,7986.62,0,0,0,0,0,0,0,0,0,0,0,0,0,0,0
Medio_bajo,No_siniestro,277953,98,518.68,0,0,0,0,0,0,0,0,0,0,0,0,0,0,0
Medio_bajo,No_siniestro,278095,92,657.21,0,0,0,0,0,0,0,0,0,0,0,0,0,0,0
Medio_bajo,No_siniestro,278360,49,4971.29,0,0,0,0,0,0,0,0,0,0,0,0,0,0,0
Medio_bajo,No_siniestro,279318,135,1983.55,0,0,0,0,0,0,0,0,0,0,0,0,0,0,0
Medio_bajo,No_siniestro,279354,13,1347.2,0,0,0,0,0,0,0,0,0,0,0,0,0,0,0
Medio_bajo,No_siniestro,279762,10,1824.2,0,0,0,0,0,0,0,0,0,0,0,0,0,0,0
Medio_bajo,No_siniestro,280217,127,4327.12,58091.27,0,0,0,0,0,0,0,0,0,0,0,0,0,0
Medio_bajo,No_siniestro,281258,56,2176.96,0,0,0,0,0,0,0,0,0,0,0,0,0,0,0
Medio_bajo,No_siniestro,282360,49,3102.95,0,0,0,0,0,0,0,0,0,0,0,0,0,0,0
Medio_bajo,No_siniestro,282543,80,10.92,0,0,0,3,2,1,1,7,0,0,0,0,0,0,0
Medio_bajo,Si_siniestro,282819,51,3501.51,0,1,0,0,0,0,0,1,0,0,0,0,0,0,0
Medio_bajo,No_siniestro,283236,42,331,0,0,0,0,0,0,0,0,0,0,0,0,0,0,0
Medio_bajo,No_siniestro,283403,115,245.33,0,0,0,0,0,0,0,0,0,0,0,0,0,0,0
Medio_bajo,No_siniestro,283968,134,1230.37,0,0,0,0,0,0,0,0,0,0,0,0,0,0,0
Medio_bajo,No_siniestro,284472,53,5354.44,0,0,0,0,0,0,0,0,0,0,0,0,0,0,0
Medio_bajo,No_siniestro,284590,49,5351.38,0,0,0,0,0,0,0,0,0,0,0,0,0,0,0
Medio_bajo,No_siniestro,285015,22,2876.04,0,0,0,0,0,0,0,0,0,0,0,0,0,0,0
Medio_bajo,No_siniestro,286005,49,145.9,0,0,0,0,0,0,0,0,0,0,0,0,0,0,0
Medio_bajo,No_siniestro,286162,41,1111.67,0,0,0,0,0,0,0,0,0,0,0,0,0,0,0
Medio_bajo,No_siniestro,286532,23,2998.22,0,0,0,0,0,0,1,1,0,0,0,0,0,0,0
Medio_bajo,No_siniestro,286737,41,181.01,0,0,0,0,0,0,0,0,0,0,0,0,0,0,0
Medio_bajo,No_siniestro,287212,35,2391.36,0,0,1,1,1,1,1,5,0,0,0,0,0,0,0
Medio_bajo,No_siniestro,287633,36,3052.44,0,0,0,0,0,0,0,0,0,0,0,0,0,0,0
Medio_bajo,No_siniestro,287670,49,9218,0,0,0,0,0,0,0,0,0,0,0,0,0,0,0
Medio_bajo,No_siniestro,288282,8,6322.14,0,0,0,0,0,0,0,0,0,0,0,0,0,0,0
Medio_bajo,No_siniestro,288464,79,21536.34,0,0,0,0,0,1,0,1,0,0,0,0,0,0,0
Medio_bajo,No_siniestro,288580,49,3040.37,0,0,0,0,0,0,0,0,0,0,0,0,0,0,0
Medio_bajo,No_siniestro,289371,92,12838.11,0,0,0,0,0,0,0,0,0,0,0,0,0,0,0
Medio_bajo,No_siniestro,289398,37,14258.64,0,0,0,0,0,0,0,0,0,0,0,0,0,0,0
Medio_bajo,No_siniestro,289460,49,3836.29,0,0,0,0,0,0,0,0,0,0,0,0,0,0,0
Medio_bajo,No_siniestro,290005,80,3104.82,0,0,0,0,0,0,0,0,0,0,0,0,0,0,0
Medio_bajo,No_siniestro,290742,65,662.26,0,0,0,0,0,0,0,0,0,0,0,0,0,0,0
Medio_bajo,No_siniestro,290914,65,1082.18,0,0,0,0,0,0,0,0,0,0,0,0,0,0,0
Medio_bajo,No_siniestro,291859,85,12448.02,0,0,0,0,0,0,0,0,0,0,0,0,0,0,0
Medio_bajo,No_siniestro,292972,70,7361.19,0,0,0,0,0,0,0,0,0,0,0,0,0,0,0
Medio_bajo,No_siniestro,293173,103,14.5,0,0,0,0,0,0,0,0,0,0,0,0,0,0,0
Medio_bajo,No_siniestro,293590,49,844.69,0,0,0,1,0,0,0,1,0,0,0,0,0,0,0
Medio_bajo,No_siniestro,293724,89,11503.37,0,0,0,0,0,0,0,0,0,0,0,0,0,0,0
Medio_bajo,No_siniestro,293868,7,5565.43,0,0,0,0,0,0,0,0,0,0,0,0,0,0,0
Medio_bajo,No_siniestro,294693,82,128.02,0,0,0,0,0,0,0,0,0,0,0,0,0,0,0
Medio_bajo,No_siniestro,296370,49,8712.78,47434.95,0,0,0,0,0,0,0,0,0,0,0,0,0,0
Medio_bajo,No_siniestro,296371,28,346.45,0,0,0,0,0,0,0,0,0,0,0,0,0,0,0
Medio_bajo,No_siniestro,296386,27,17.68,0,0,0,0,0,0,1,1,0,0,0,0,0,0,0
Medio_bajo,No_siniestro,296684,25,16289.24,37398.76,0,0,0,0,0,0,0,0,0,0,0,0,0,0
Medio_bajo,No_siniestro,296751,87,8855.84,0,0,0,0,0,0,1,1,0,0,0,0,0,0,0
Medio_bajo,No_siniestro,296811,45,571.32,0,0,0,0,0,0,0,0,0,0,0,0,0,0,0
Medio_bajo,No_siniestro,297401,47,6377.29,59883.05,0,0,0,0,0,1,1,0,0,0,0,0,0,0
Medio_bajo,No_siniestro,297761,54,271.54,0,0,0,0,0,0,0,0,0,0,0,0,0,0,0
Medio_bajo,No_siniestro,298170,49,1313.05,30056.06,0,0,0,0,0,0,0,0,0,0,0,0,0,0
Medio_bajo,No_siniestro,298769,49,8142.74,0,0,0,0,0,0,0,0,0,0,0,0,0,0,0
Medio_bajo,No_siniestro,299329,12,5164.88,0,0,0,0,0,0,0,0,0,0,0,0,0,0,0
Medio_bajo,No_siniestro,299393,47,258.66,0,0,0,0,0,0,0,0,0,0,0,0,0,0,0
Medio_bajo,No_siniestro,299658,6,342.65,0,0,0,0,0,0,0,0,0,0,0,0,0,0,0
Medio_bajo,No_siniestro,299704,39,2594.17,0,1,1,0,0,0,0,2,0,0,0,0,0,0,0
Medio_bajo,No_siniestro,300339,56,135.12,0,0,0,0,0,0,0,0,0,0,0,0,0,0,0
Medio_bajo,No_siniestro,300585,7,5761.19,0,2,1,0,0,0,0,3,0,0,0,0,0,0,0
Medio_bajo,No_siniestro,300700,49,754.51,51848.31,0,0,0,0,0,0,0,0,0,0,0,0,0,0
Medio_bajo,No_siniestro,301735,20,793.48,0,0,0,0,0,1,1,2,0,0,0,0,0,0,0
Medio_bajo,No_siniestro,301988,9,218.04,0,0,0,0,0,0,0,0,0,0,0,0,0,0,0
Medio_bajo,No_siniestro,302569,45,337.42,0,0,0,0,0,0,0,0,0,0,0,0,0,0,0
Medio_bajo,No_siniestro,302720,49,399.91,0,0,0,0,0,0,0,0,0,0,0,0,0,0,0
Medio_bajo,No_siniestro,302963,21,815.64,0,0,0,0,0,0,0,0,0,0,0,0,0,0,0
Medio_bajo,No_siniestro,303037,50,29522.13,0,0,0,0,0,0,0,0,0,0,0,0,0,0,0
Medio_bajo,No_siniestro,304158,29,774.81,0,0,0,0,0,0,0,0,0,0,0,0,0,0,0
Medio_bajo,No_siniestro,305262,58,4206.49,0,0,0,0,0,0,0,0,0,0,0,0,0,0,0
Medio_bajo,No_siniestro,306496,19,129.84,0,0,0,0,0,0,0,0,0,0,0,0,0,0,0
Medio_bajo,No_siniestro,310041,13,1168.36,0,0,0,0,0,0,0,0,0,0,0,0,0,0,0
Medio_bajo,No_siniestro,316485,32,875.88,0,0,0,0,0,0,0,0,0,0,0,0,0,0,0
Medio_bajo,No_siniestro,316952,7,1636.73,0,1,1,1,0,0,0,3,0,0,0,0,0,0,0
Medio_bajo,No_siniestro,317892,25,1234.65,0,0,0,0,0,0,0,0,0,0,0,0,0,0,0
Medio_bajo,No_siniestro,317988,20,438.93,0,0,0,0,0,0,0,0,0,0,0,0,0,0,0
Medio_bajo,No_siniestro,318180,49,599.88,0,0,0,0,0,0,0,0,0,0,0,0,0,0,0
Medio_bajo,No_siniestro,318455,40,446.7,0,0,0,0,0,0,0,0,0,0,0,0,0,0,0
Medio_bajo,No_siniestro,318743,15,511.78,0,0,0,0,0,0,0,0,0,0,0,0,0,0,0
Medio_bajo,No_siniestro,318763,30,3802.32,0,0,0,0,0,0,0,0,0,0,0,0,0,0,0
Medio_bajo,No_siniestro,319266,96,1145.61,0,0,0,0,0,0,0,0,0,0,0,0,0,0,0
Medio_bajo,No_siniestro,319713,54,331.98,0,0,0,0,0,0,0,0,0,0,0,0,0,0,0
Medio_bajo,No_siniestro,320693,45,935.24,0,0,0,0,0,0,0,0,0,0,0,0,0,0,0
Medio_bajo,No_siniestro,320820,49,6260.7,0,0,0,0,0,0,0,0,0,0,0,0,0,0,0
Medio_bajo,No_siniestro,321010,49,11212.63,0,0,0,0,0,0,0,0,0,0,0,0,0,0,0
Medio_bajo,No_siniestro,321051,111,3017.69,0,0,0,0,0,0,0,0,0,0,0,0,0,0,0
Medio_bajo,No_siniestro,322130,49,516.67,0,0,0,0,0,0,0,0,0,0,0,0,0,0,0
Medio_bajo,No_siniestro,322196,51,5658.19,0,0,0,0,0,0,0,0,0,0,0,0,0,0,0
Medio_bajo,No_siniestro,322382,44,2715.39,0,0,0,0,0,0,0,0,0,0,0,0,0,0,0
Medio_bajo,No_siniestro,323204,32,12340.72,0,0,0,0,0,0,0,0,0,0,0,0,0,0,0
Medio_bajo,No_siniestro,323218,61,823.46,0,0,0,0,0,0,0,0,0,0,0,0,0,0,0
Medio_bajo,No_siniestro,323276,58,430.19,0,0,0,0,0,0,0,0,0,0,0,0,0,0,0
Medio_bajo,No_siniestro,323408,66,2557.94,0,0,0,0,0,0,0,0,0,0,0,0,0,0,0
Medio_bajo,No_siniestro,323950,44,22010.86,0,0,0,0,0,0,0,0,0,0,0,0,0,0,0
Medio_bajo,No_siniestro,324180,44,6205.16,0,0,0,0,0,0,0,0,0,0,0,0,0,0,0
Medio_bajo,No_siniestro,324511,22,12509.69,0,0,0,0,0,0,0,0,0,0,0,0,0,0,0
Medio_bajo,No_siniestro,324650,44,186.86,0,0,0,0,0,0,0,0,0,0,0,0,0,0,0
Medio_bajo,No_siniestro,325036,81,2363.87,0,0,0,0,0,0,0,0,0,0,0,0,0,0,0
Medio_bajo,No_siniestro,326127,39,1706,0,0,0,0,0,0,0,0,0,0,0,0,0,0,0
Medio_bajo,No_siniestro,326151,66,5943.5,0,0,0,0,0,0,0,0,0,0,0,0,0,0,0
Medio_bajo,No_siniestro,326335,133,775.73,0,0,0,0,0,0,0,0,0,0,0,0,0,0,0
Medio_bajo,No_siniestro,326488,8,281.85,0,1,0,0,0,0,0,1,0,0,0,0,0,0,0
Medio_bajo,No_siniestro,327135,59,93.16,30755.94,0,0,0,0,0,0,0,0,0,0,0,0,0,0
Medio_bajo,No_siniestro,327370,44,314.86,0,0,0,0,0,0,0,0,0,0,0,0,0,0,0
Medio_bajo,No_siniestro,328284,56,656.8,0,0,0,0,0,1,0,1,0,0,0,0,0,0,0
Medio_bajo,No_siniestro,329432,60,0.04,0,0,0,0,0,0,0,0,0,0,0,0,0,0,0
Medio_bajo,No_siniestro,329602,41,5220.29,0,0,0,0,0,0,0,0,0,0,0,0,0,0,0
Medio_bajo,No_siniestro,330661,102,813.56,0,0,0,0,0,0,0,0,0,0,0,0,0,0,0
Medio_bajo,No_siniestro,330950,44,1353.97,0,0,0,0,0,0,1,1,0,0,0,0,0,0,0
Medio_bajo,No_siniestro,331096,61,884,0,0,0,0,0,0,0,0,0,0,0,0,0,0,0
Medio_bajo,No_siniestro,331159,39,6207.2,0,0,0,0,0,0,0,0,0,0,0,0,0,0,0
Medio_bajo,No_siniestro,331694,76,219.08,0,0,0,0,0,0,0,0,0,0,0,0,0,0,0
Medio_bajo,No_siniestro,331914,150,16569.06,0,0,0,0,0,0,0,0,0,0,0,0,0,0,0
Medio_bajo,No_siniestro,332000,44,118.59,0,0,0,0,0,0,0,0,0,0,0,0,0,0,0
Medio_bajo,No_siniestro,332511,34,1402.83,0,0,0,0,0,0,0,0,0,0,0,0,0,0,0
Medio_bajo,No_siniestro,332513,32,23.34,0,0,0,0,0,0,0,0,0,0,0,0,0,0,0
Medio_bajo,No_siniestro,332642,86,999.19,0,0,0,0,0,0,0,0,0,0,0,0,0,0,0
Medio_bajo,No_siniestro,333363,85,221.46,0,0,0,0,0,0,0,0,0,0,0,0,0,0,0
Medio_bajo,No_siniestro,334407,30,3299.65,0,0,0,0,0,0,0,0,0,0,0,0,0,0,0
Medio_bajo,No_siniestro,334653,190,3544.86,0,0,0,0,0,0,0,0,0,0,0,0,0,0,0
Medio_bajo,No_siniestro,335118,35,358.86,0,0,0,0,0,0,0,0,0,0,0,0,0,0,0
Medio_bajo,No_siniestro,335294,32,807.12,0,0,0,0,0,0,0,0,0,0,0,0,0,0,0
Medio_bajo,No_siniestro,335571,41,2894.22,0,0,0,0,0,0,0,0,0,0,0,0,0,0,0
Medio_bajo,No_siniestro,335653,40,450.64,0,0,0,0,0,0,0,0,0,0,0,0,0,0,0
Medio_bajo,No_siniestro,336192,18,26283.8,0,1,0,1,0,0,0,2,0,0,0,0,0,0,0
Medio_bajo,No_siniestro,336219,30,2779.78,0,0,0,0,0,0,0,0,0,0,0,0,0,0,0
Medio_bajo,No_siniestro,336725,7,0.18,19196.78,0,0,0,0,0,0,0,0,0,0,0,0,0,0
Medio_bajo,No_siniestro,337269,96,14790.49,0,1,1,1,1,0,0,4,0,0,0,0,0,0,0
Medio_bajo,No_siniestro,338007,84,1417.13,0,0,0,0,0,0,0,0,0,0,0,0,0,0,0
Medio_bajo,No_siniestro,338228,67,1836.57,0,0,0,0,0,0,0,0,0,0,0,0,0,0,0
Medio_bajo,No_siniestro,338682,114,1714.27,0,0,0,0,0,0,0,0,0,0,0,0,0,0,0
Medio_bajo,No_siniestro,339108,19,3.38,0,0,0,0,0,0,0,0,0,0,0,0,0,0,0
Medio_bajo,No_siniestro,340073,12,2487.05,0,0,0,0,0,0,0,0,0,0,0,0,0,0,0
Medio_bajo,No_siniestro,340243,35,1963.76,0,0,0,0,0,0,0,0,0,0,0,0,0,0,0
Medio_bajo,No_siniestro,341665,67,10995.97,18327.5,0,0,0,0,0,0,0,0,0,0,0,0,0,0
Medio_bajo,No_siniestro,341978,99,3221.54,0,0,0,0,0,0,0,0,0,0,0,0,0,0,0
Medio_bajo,No_siniestro,342890,44,3767.14,0,0,0,0,0,0,0,0,0,0,0,0,0,0,0
Medio_bajo,No_siniestro,343390,44,2583.88,0,0,0,0,0,0,0,0,0,0,0,0,0,0,0
Medio_bajo,No_siniestro,343453,43,59.96,0,0,0,0,0,0,0,0,0,0,0,0,0,0,0
Medio_bajo,No_siniestro,343680,44,971.65,0,0,0,0,0,0,0,0,0,0,0,0,0,0,0
Medio_bajo,No_siniestro,343702,78,6260.8,0,0,0,0,0,0,0,0,0,0,0,0,0,0,0
Medio_bajo,No_siniestro,344079,25,5055.57,0,0,0,0,0,0,0,0,0,0,0,0,0,0,0
Medio_bajo,No_siniestro,344841,7,12078.47,0,0,0,0,0,0,0,0,0,0,0,0,0,0,0
Medio_bajo,Si_siniestro,345138,9,901.34,0,0,1,0,0,0,0,1,0,0,0,0,0,0,0
Medio_bajo,No_siniestro,345385,17,614.22,99948.72,0,0,0,0,0,0,0,0,0,0,0,0,0,0
Medio_bajo,No_siniestro,346038,44,3023.97,0,0,0,0,0,0,0,0,0,0,0,0,0,0,0
Medio_bajo,No_siniestro,346132,44,40.97,0,0,0,0,0,0,0,0,0,0,0,0,0,0,0
Medio_bajo,No_siniestro,346665,35,3290.04,0,0,0,0,0,0,0,0,0,0,0,0,0,0,0
Medio_bajo,No_siniestro,347258,88,210.27,0,0,0,0,0,0,0,0,0,0,0,0,0,0,0
Medio_bajo,No_siniestro,347634,59,116.12,0,0,0,0,0,0,0,0,0,0,0,0,0,0,0
Medio_bajo,No_siniestro,347729,81,11342.69,0,0,0,0,0,0,0,0,0,0,0,0,0,0,0
Medio_bajo,No_siniestro,347769,7,851.03,0,0,0,0,0,0,0,0,0,0,0,0,0,0,0
Medio_bajo,No_siniestro,348058,26,3463.22,0,0,0,0,0,0,0,0,0,0,0,0,0,0,0
Medio_bajo,No_siniestro,348446,30,2676.67,0,0,0,0,0,0,0,0,0,0,0,0,0,0,0
Medio_bajo,No_siniestro,348497,48,4318.37,0,1,0,0,0,0,0,1,0,0,0,0,0,0,0
Medio_bajo,No_siniestro,348506,26,1590.87,0,0,0,0,0,0,0,0,0,0,0,0,0,0,0
Medio_bajo,No_siniestro,348575,82,1057.63,0,0,0,0,0,0,0,0,0,0,0,0,0,0,0
Medio_bajo,No_siniestro,348589,68,45.85,0,0,0,0,0,0,0,0,0,0,0,0,0,0,0
Medio_bajo,No_siniestro,348693,39,6748.42,0,0,0,0,0,0,0,0,0,0,0,0,0,0,0
Medio_bajo,No_siniestro,348853,49,186.79,0,0,0,0,0,0,0,0,0,0,0,0,0,0,0
Medio_bajo,No_siniestro,348865,45,6.33,0,0,0,0,0,0,0,0,0,0,0,0,0,0,0
Medio_bajo,No_siniestro,349010,44,912.62,0,1,0,0,0,0,0,1,0,0,0,0,0,0,0
Medio_bajo,No_siniestro,349359,101,287.37,0,0,0,0,0,0,0,0,0,0,0,0,0,0,0
Medio_bajo,No_siniestro,349489,29,7762.53,0,0,0,0,0,0,0,0,0,0,0,0,0,0,0
Medio_bajo,No_siniestro,349602,38,5903.11,0,0,0,0,0,0,0,0,0,0,0,0,0,0,0
Medio_bajo,No_siniestro,350403,6,2459.79,0,0,0,0,0,0,0,0,0,0,0,0,0,0,0
Medio_bajo,No_siniestro,350573,63,17432.65,52770.25,0,0,0,0,0,0,0,0,0,0,0,0,0,0
Medio_bajo,No_siniestro,350718,43,49.21,0,0,0,0,0,0,0,0,0,0,0,0,0,0,0
Medio_bajo,No_siniestro,351053,165,1189.87,0,0,0,0,0,0,0,0,0,0,0,0,0,0,0
Medio_bajo,No_siniestro,351158,144,929.44,0,0,0,0,0,0,0,0,0,0,0,0,0,0,0
Medio_bajo,No_siniestro,351197,110,855.72,0,0,0,0,0,0,0,0,0,0,0,0,0,0,0
Medio_bajo,No_siniestro,351548,12,1702.64,0,0,0,0,0,0,0,0,0,0,0,0,0,0,0
Medio_bajo,No_siniestro,351724,125,67.06,0,0,0,0,0,0,0,0,0,0,0,0,0,0,0
Medio_bajo,No_siniestro,352785,163,2505.77,0,0,0,0,0,0,1,1,0,0,0,0,0,0,0
Medio_bajo,No_siniestro,352804,82,12504.66,0,0,0,0,0,0,0,0,0,0,0,0,0,0,0
Medio_bajo,No_siniestro,353394,17,57.93,0,0,0,0,0,0,0,0,0,0,0,0,0,0,0
Medio_bajo,No_siniestro,353463,7,11688.52,0,0,0,0,0,0,0,0,0,0,0,0,0,0,0
Medio_bajo,No_siniestro,353774,136,1555.87,0,0,0,0,0,0,0,0,0,0,0,0,0,0,0
Medio_bajo,No_siniestro,354638,15,6581.21,0,0,0,0,0,0,0,0,0,0,0,0,0,0,0
Medio_bajo,No_siniestro,354842,26,176.07,49231.88,0,0,0,0,0,0,0,0,0,0,0,0,0,0
Medio_bajo,No_siniestro,355193,29,1224.01,0,0,0,0,0,0,0,0,0,0,0,0,0,0,0
Medio_bajo,No_siniestro,355587,12,97.44,0,0,0,0,0,0,0,0,0,0,0,0,0,0,0
Medio_bajo,No_siniestro,355825,62,5478.95,0,0,0,0,0,0,0,0,0,0,0,0,0,0,0
Medio_bajo,No_siniestro,356230,44,1853.16,0,0,0,0,0,0,0,0,0,0,0,0,0,0,0
Medio_bajo,No_siniestro,356391,107,589.3,0,0,0,0,0,0,0,0,0,0,0,0,0,0,0
Medio_bajo,No_siniestro,356715,108,1.09,13182.5,0,0,0,0,0,0,0,0,0,0,0,0,0,0
Medio_bajo,No_siniestro,356809,47,255.93,0,1,0,0,0,0,0,1,0,0,0,0,0,0,0
Medio_bajo,No_siniestro,357190,44,3800.66,56022.31,0,0,0,0,0,0,0,0,0,0,0,0,0,0
Medio_bajo,No_siniestro,357404,13,258.22,0,0,0,0,0,0,0,0,0,0,0,0,0,0,0
Medio_bajo,No_siniestro,357490,44,699.78,30305.56,0,0,0,0,0,0,0,0,0,0,0,0,0,0
Medio_bajo,No_siniestro,357657,67,17131.56,0,0,0,0,0,0,0,0,0,0,0,0,0,0,0
Medio_bajo,No_siniestro,358629,64,31.72,0,0,0,0,0,0,0,0,0,0,0,0,0,0,0
Medio_bajo,No_siniestro,358641,35,3200.79,0,0,0,0,0,0,0,0,0,0,0,0,0,0,0
Medio_bajo,No_siniestro,358690,44,1502.65,0,0,0,0,0,0,0,0,0,0,0,0,0,0,0
Medio_bajo,No_siniestro,358747,45,1176.99,0,0,0,0,0,0,0,0,0,0,0,0,0,0,0
Medio_bajo,No_siniestro,359171,116,593.91,0,0,0,0,0,0,0,0,0,0,0,0,0,0,0
Medio_bajo,No_siniestro,359553,68,1268.71,0,0,0,0,0,0,0,0,0,0,0,0,0,0,0
Medio_bajo,No_siniestro,360864,64,962.43,0,0,0,0,0,0,0,0,0,0,0,0,0,0,0
Medio_bajo,No_siniestro,361876,7,7948.08,0,0,0,0,0,0,0,0,0,0,0,0,0,0,0
Medio_bajo,No_siniestro,361893,108,87.1,0,0,0,0,0,0,0,0,0,0,0,0,0,0,0
Medio_bajo,No_siniestro,362016,99,1175.28,17451.43,0,0,0,0,0,0,0,0,0,0,0,0,0,0
Medio_bajo,No_siniestro,362562,72,151.74,0,0,0,0,1,0,0,1,0,0,0,0,0,0,0
Medio_bajo,No_siniestro,362754,18,373.45,0,0,0,0,0,0,0,0,0,0,0,0,0,0,0
Medio_bajo,No_siniestro,363515,42,3854.62,0,0,0,0,0,0,0,0,0,0,0,0,0,0,0
Medio_bajo,No_siniestro,363832,34,815.44,0,0,0,0,0,0,0,0,0,0,0,0,0,0,0
Medio_bajo,No_siniestro,364362,33,219.35,0,0,0,0,0,0,0,0,0,0,0,0,0,0,0
Medio_bajo,No_siniestro,365220,44,3782.99,0,0,0,0,0,0,0,0,0,0,0,0,0,0,0
Medio_bajo,No_siniestro,365467,24,9137.66,0,0,0,0,0,0,0,0,0,0,0,0,0,0,0
Medio_bajo,No_siniestro,366625,13,236.11,23104.96,0,0,0,0,0,0,0,0,0,0,0,0,0,0
Medio_bajo,No_siniestro,367265,74,3943.98,0,0,1,0,0,0,0,1,0,0,0,0,0,0,0
Medio_bajo,No_siniestro,368798,8,1252.22,0,0,0,0,0,0,0,0,0,0,0,0,0,0,0
Medio_bajo,No_siniestro,368909,32,1655.06,0,0,0,0,0,0,0,0,0,0,0,0,0,0,0
Medio_bajo,No_siniestro,370545,40,928.95,0,0,0,0,0,0,0,0,0,0,0,0,0,0,0
Medio_bajo,No_siniestro,370584,8,1943.87,0,0,0,0,0,0,0,0,0,0,0,0,0,0,0
Medio_bajo,No_siniestro,371218,64,559.83,0,0,0,0,0,0,0,0,0,0,0,0,0,0,0
Medio_bajo,No_siniestro,374084,10,85.57,0,0,0,0,0,0,0,0,0,0,0,0,0,0,0
Medio_bajo,No_siniestro,381437,112,459.23,0,0,0,0,0,0,0,0,0,0,0,0,0,0,0
Medio_bajo,No_siniestro,381529,126,578.86,0,0,0,0,0,0,0,0,0,0,0,0,0,0,0
Medio_bajo,No_siniestro,382063,201,509.06,0,0,0,0,0,0,0,0,0,0,0,0,0,0,0
Medio_bajo,No_siniestro,382779,123,328.47,0,0,0,0,0,0,0,0,0,0,0,0,0,0,0
Medio_bajo,No_siniestro,383860,44,15574.7,7504.3,0,0,0,0,0,0,0,0,0,0,0,0,0,0
Medio_bajo,No_siniestro,383956,14,1998.15,0,0,0,0,0,0,0,0,0,0,0,0,0,0,0
Medio_bajo,No_siniestro,384196,61,1103.02,0,0,0,0,0,0,0,0,0,0,0,0,0,0,0
Medio_bajo,No_siniestro,384205,149,775.76,3970.23,0,0,0,0,0,0,0,0,0,0,0,0,0,0
Medio_bajo,No_siniestro,384406,93,137.06,0,0,0,0,0,0,0,0,0,0,0,0,0,0,0
Medio_bajo,No_siniestro,385302,186,600.32,0,0,0,0,0,0,0,0,0,0,0,0,0,0,0
Medio_bajo,No_siniestro,385316,66,6198.04,0,0,0,0,0,0,0,0,0,0,0,0,0,0,0
Medio_bajo,No_siniestro,385425,39,2908.42,0,0,0,0,0,0,0,0,0,0,0,0,0,0,0
Medio_bajo,No_siniestro,385847,115,5590.63,0,0,0,0,0,0,0,0,0,0,0,0,0,0,0
Medio_bajo,No_siniestro,385930,44,226.62,0,0,0,0,0,0,0,0,0,0,0,0,0,0,0
Medio_bajo,No_siniestro,387506,8,10528.85,0,0,0,0,0,0,0,0,0,0,0,0,0,0,0
Medio_bajo,No_siniestro,388142,120,2501.43,0,0,0,0,0,0,0,0,0,0,0,0,0,0,0
Medio_bajo,No_siniestro,389076,149,1101.43,0,0,0,0,0,0,0,0,0,0,0,0,0,0,0
Medio_bajo,No_siniestro,389144,104,2153.75,0,0,0,0,0,0,0,0,0,0,0,0,0,0,0
Medio_bajo,No_siniestro,389260,44,8388.7,59471.28,0,0,0,0,0,0,0,0,0,0,0,0,0,0
Medio_bajo,No_siniestro,389696,78,6430.19,0,0,0,0,0,0,0,0,0,0,0,0,0,0,0
Medio_bajo,No_siniestro,390060,44,1432.36,0,0,0,0,1,0,0,1,0,0,0,0,0,0,0
Medio_bajo,No_siniestro,390280,44,448.95,8163.05,0,0,0,0,0,0,0,0,0,0,0,0,0,0
Medio_bajo,No_siniestro,390371,158,12996.32,0,0,0,0,0,0,0,0,0,0,0,0,0,0,0
Medio_bajo,No_siniestro,390856,76,802.68,0,0,0,0,0,0,0,0,0,0,0,0,0,0,0
Medio_bajo,No_siniestro,391034,65,5699.99,0,0,0,0,0,1,0,1,0,0,0,0,0,0,0
Medio_bajo,No_siniestro,392505,39,1179.17,0,0,0,0,0,0,0,0,0,0,0,0,0,0,0
Medio_bajo,No_siniestro,392850,44,49.19,0,0,0,0,0,0,0,0,0,0,0,0,0,0,0
Medio_bajo,No_siniestro,392888,15,12.97,0,0,0,0,0,0,0,0,0,0,0,0,0,0,0
Medio_bajo,No_siniestro,393155,40,547.44,0,0,0,0,0,0,0,0,0,0,0,0,0,0,0
Medio_bajo,Si_siniestro,394290,44,901.6,0,3,2,1,0,0,0,6,0,0,0,0,0,0,0
Medio_bajo,No_siniestro,394820,44,11695.45,0,0,0,0,0,0,0,0,0,0,0,0,0,0,0
Medio_bajo,No_siniestro,395725,143,2147.7,0,0,0,0,0,0,0,0,0,0,0,0,0,0,0
Medio_bajo,No_siniestro,395737,10,304.9,0,0,0,0,0,0,0,0,0,0,0,0,0,0,0
Medio_bajo,No_siniestro,396129,25,96.92,0,0,0,0,0,0,0,0,0,0,0,0,0,0,0
Medio_bajo,No_siniestro,396194,16,3606.95,0,0,0,0,0,0,0,0,0,0,0,0,0,0,0
Medio_bajo,No_siniestro,396666,63,0.9,0,0,0,0,0,0,0,0,0,0,0,0,0,0,0
Medio_bajo,No_siniestro,397123,53,1296.07,0,0,0,0,0,0,0,0,0,0,0,0,0,0,0
Medio_bajo,Si_siniestro,397275,37,254.03,0,0,0,0,0,0,0,0,0,0,0,0,0,0,0
Medio_bajo,No_siniestro,397695,38,2703.66,0,0,0,0,0,0,0,0,0,0,0,0,0,0,0
Medio_bajo,No_siniestro,398111,9,4469.81,0,0,0,0,0,0,0,0,0,0,0,0,0,0,0
Medio_bajo,No_siniestro,398335,80,1706.13,0,0,0,1,0,1,0,2,0,0,0,0,0,0,0
Medio_bajo,No_siniestro,398362,86,544.45,60521.52,0,0,0,0,0,0,0,0,0,0,0,0,0,0
Medio_bajo,No_siniestro,398538,224,1784.14,0,0,0,0,0,0,0,0,0,0,0,0,0,0,0
Medio_bajo,No_siniestro,399179,96,1192.06,0,0,0,0,0,0,0,0,0,0,0,0,0,0,0
Medio_bajo,No_siniestro,399717,80,792.05,0,0,1,0,0,0,0,1,0,0,0,0,0,0,0
Medio_bajo,No_siniestro,399793,26,4347.44,0,0,0,0,0,0,0,0,0,0,0,0,0,0,0
Medio_bajo,No_siniestro,399802,14,2022.51,0,0,0,0,0,0,0,0,0,0,0,0,0,0,0
Medio_bajo,No_siniestro,400050,44,979.15,0,0,0,0,0,0,0,0,0,0,0,0,0,0,0
Medio_bajo,No_siniestro,400369,98,50598.89,0,0,0,0,0,0,0,0,0,0,0,0,0,0,0
Medio_bajo,No_siniestro,400653,6,5281.59,0,1,0,0,0,0,0,1,0,0,0,0,0,0,0
Medio_bajo,No_siniestro,400895,90,168.92,30874.66,0,0,0,0,0,0,0,0,0,0,0,0,0,0
Medio_bajo,No_siniestro,401199,122,10199.5,0,0,0,0,0,0,0,0,0,0,0,0,0,0,0
Medio_bajo,No_siniestro,401654,6,5534.21,0,0,0,0,0,0,0,0,0,0,0,0,0,0,0
Medio_bajo,No_siniestro,401767,118,7464.05,0,0,0,0,0,0,0,0,0,0,0,0,0,0,0
Medio_bajo,No_siniestro,403090,44,7226.82,0,0,0,0,0,0,0,0,0,0,0,0,0,0,0
Medio_bajo,No_siniestro,403569,14,2079.01,0,0,0,0,0,0,0,0,0,0,0,0,0,0,0
Medio_bajo,No_siniestro,403624,27,1768.11,0,0,0,0,0,0,0,0,0,0,0,0,0,0,0
Medio_bajo,No_siniestro,404108,101,1526.16,0,0,0,0,0,0,0,0,0,0,0,0,0,0,0
Medio_bajo,No_siniestro,404118,60,2104.34,0,0,0,0,0,0,0,0,0,0,0,0,0,0,0
Medio_bajo,No_siniestro,404884,48,2.11,0,0,0,0,0,0,0,0,0,0,0,0,0,0,0
Medio_bajo,No_siniestro,405026,27,5419,26675.05,0,0,0,0,0,0,0,0,0,0,0,0,0,0
Medio_bajo,No_siniestro,405381,120,465.81,0,0,0,0,0,0,0,0,0,0,0,0,0,0,0
Medio_bajo,No_siniestro,406142,53,457.66,0,0,0,0,0,0,0,0,0,0,0,0,0,0,0
Medio_bajo,No_siniestro,406156,45,153.14,0,0,0,0,0,0,0,0,0,0,0,0,0,0,0
Medio_bajo,No_siniestro,406465,52,3169.53,28650.13,0,0,0,0,0,0,0,0,0,0,0,0,0,0
Medio_bajo,No_siniestro,406488,188,2359.91,0,0,0,0,0,0,0,0,0,0,0,0,0,0,0
Medio_bajo,No_siniestro,406539,28,2805.24,0,0,0,0,0,0,0,0,0,0,0,0,0,0,0
Medio_bajo,No_siniestro,406769,9,30.11,0,0,0,0,0,0,0,0,0,0,0,0,0,0,0
Medio_bajo,No_siniestro,407841,25,96.41,0,0,0,0,0,0,0,0,0,0,0,0,0,0,0
Medio_bajo,No_siniestro,408055,6,37.13,0,0,0,0,0,0,0,0,0,0,0,0,0,0,0
Medio_bajo,No_siniestro,408520,44,2611.33,0,0,0,0,0,0,0,0,0,0,0,0,0,0,0
Medio_bajo,No_siniestro,408715,42,632.36,0,0,0,0,0,0,0,0,0,0,0,0,0,0,0
Medio_bajo,No_siniestro,409088,50,6449.27,50316.01,0,0,0,0,0,0,0,0,0,0,0,0,0,0
Medio_bajo,No_siniestro,409559,51,647.08,0,0,0,0,0,0,0,0,0,0,0,0,0,0,0
Medio_bajo,No_siniestro,410026,96,1779.26,0,0,0,0,0,0,0,0,0,0,0,0,0,0,0
Medio_bajo,No_siniestro,410391,67,8935.98,0,0,0,0,0,0,0,0,0,0,0,0,0,0,0
Medio_bajo,No_siniestro,410597,68,6047.07,73643.57,0,0,0,0,0,0,0,0,0,0,0,0,0,0
Medio_bajo,No_siniestro,410846,125,3456.75,0,0,0,0,0,0,0,0,0,0,0,0,0,0,0
Medio_bajo,No_siniestro,412365,58,409.72,49769.19,0,0,0,0,0,0,0,0,0,0,0,0,0,0
Medio_bajo,No_siniestro,412556,112,415.63,0,0,0,0,0,0,0,0,0,0,0,0,0,0,0
Medio_bajo,No_siniestro,412934,67,873.6,0,0,0,0,0,0,0,0,0,0,0,0,0,0,0
Medio_bajo,No_siniestro,413054,9,1432.13,0,0,0,0,0,0,0,0,0,0,0,0,0,0,0
Medio_bajo,No_siniestro,413496,12,1372.34,0,0,0,0,0,0,0,0,0,0,0,0,0,0,0
Medio_bajo,No_siniestro,414777,34,3460.46,0,0,0,0,0,0,0,0,0,0,0,0,0,0,0
Medio_bajo,No_siniestro,414829,41,0.09,0,0,0,0,0,0,0,0,0,0,0,0,0,0,0
Medio_bajo,No_siniestro,415046,43,12490.41,34116.8,0,0,0,0,0,0,0,0,0,0,0,0,0,0
Medio_bajo,No_siniestro,415115,79,259.31,0,0,0,0,0,0,0,0,0,0,0,0,0,0,0
Medio_bajo,No_siniestro,415646,48,11322.18,0,0,0,0,0,0,0,0,0,0,0,0,0,0,0
Medio_bajo,No_siniestro,415859,67,7983.79,0,0,0,0,0,0,0,0,0,0,0,0,0,0,0
Medio_bajo,No_siniestro,416426,12,10724.54,0,0,0,0,0,0,0,0,0,0,0,0,0,0,0
Medio_bajo,No_siniestro,416517,8,114.19,0,0,0,0,0,0,0,0,0,0,0,0,0,0,0
Medio_bajo,No_siniestro,416860,44,6445.04,0,0,0,0,0,0,0,0,0,0,0,0,0,0,0
Medio_bajo,No_siniestro,416891,29,2788.41,0,0,0,0,0,0,0,0,0,0,0,0,0,0,0
Medio_bajo,No_siniestro,416965,6,8466.61,0,0,0,0,0,0,0,0,0,0,0,0,0,0,0
Medio_bajo,No_siniestro,417632,89,128.74,0,0,0,0,0,0,0,0,0,0,0,0,0,0,0
Medio_bajo,No_siniestro,417736,83,1358.91,0,0,0,0,0,0,0,0,0,0,0,0,0,0,0
Medio_bajo,No_siniestro,418136,142,145.71,0,0,0,0,0,0,0,0,0,0,0,0,0,0,0
Medio_bajo,No_siniestro,418158,63,299.05,0,0,0,0,0,0,1,1,0,0,0,0,0,0,0
Medio_bajo,No_siniestro,418851,25,2937.42,0,0,0,0,0,0,0,0,0,0,0,0,0,0,0
Medio_bajo,No_siniestro,419245,29,4544.3,0,0,0,0,0,0,0,0,0,0,0,0,0,0,0
Medio_bajo,No_siniestro,419647,15,1260.62,0,0,1,0,0,0,0,1,0,0,0,0,0,0,0
Medio_bajo,Si_siniestro,419980,44,54.82,0,0,0,0,0,0,0,0,0,0,0,0,0,0,0
Medio_bajo,No_siniestro,420767,50,1179.75,0,0,0,0,0,0,0,0,0,0,0,0,0,0,0
Medio_bajo,No_siniestro,420850,44,7427.74,0,0,0,0,0,0,0,0,0,0,0,0,0,0,0
Medio_bajo,No_siniestro,422206,94,526.02,77624.5,0,0,0,0,0,0,0,0,0,0,0,0,0,0
Medio_bajo,No_siniestro,422210,44,452.31,0,0,0,0,0,0,0,0,0,0,0,0,0,0,0
Medio_bajo,No_siniestro,422479,13,4536.04,0,0,0,0,0,0,0,0,0,0,0,0,0,0,0
Medio_bajo,No_siniestro,422521,49,785.02,0,0,0,0,0,0,0,0,0,0,0,0,0,0,0
Medio_bajo,No_siniestro,422575,70,1271.7,0,0,0,0,0,0,0,0,0,0,0,0,0,0,0
Medio_bajo,No_siniestro,423321,60,1403.57,0,0,0,0,0,0,0,0,0,0,0,0,0,0,0
Medio_bajo,No_siniestro,423812,18,238.95,46587.48,0,0,0,0,0,0,0,0,0,0,0,0,0,0
Medio_bajo,No_siniestro,424322,58,1225.3,0,0,0,0,0,0,0,0,0,0,0,0,0,0,0
Medio_bajo,No_siniestro,424325,28,16454.07,36057.58,0,0,0,0,0,0,0,0,0,0,0,0,0,0
Medio_bajo,No_siniestro,424965,83,720.41,72878.9,0,0,0,0,0,0,0,0,0,0,0,0,0,0
Medio_bajo,No_siniestro,424970,44,1841.73,0,0,0,0,0,0,0,0,0,0,0,0,0,0,0
Medio_bajo,No_siniestro,425249,33,996.6,0,0,0,0,0,0,0,0,0,0,0,0,0,0,0
Medio_bajo,No_siniestro,425296,30,5091.23,0,0,0,0,0,0,1,1,0,0,0,0,0,0,0
Medio_bajo,No_siniestro,425408,78,100.48,0,0,0,0,0,0,0,0,0,0,0,0,0,0,0
Medio_bajo,No_siniestro,425488,63,2003.82,0,0,0,0,0,0,0,0,0,0,0,0,0,0,0
Medio_bajo,No_siniestro,425750,44,3725.11,0,0,0,0,0,0,0,0,0,0,0,0,0,0,0
Medio_bajo,No_siniestro,425769,10,288.5,0,0,0,0,0,0,0,0,0,0,0,0,0,0,0
Medio_bajo,No_siniestro,425776,47,40.59,0,0,0,0,0,0,0,0,0,0,0,0,0,0,0
Medio_bajo,No_siniestro,426345,57,904.88,0,0,0,0,0,0,0,0,0,0,0,0,0,0,0
Medio_bajo,No_siniestro,426387,7,18374.19,0,0,0,0,0,0,0,0,0,0,0,0,0,0,0
Medio_bajo,No_siniestro,426931,76,55.83,0,0,0,0,0,0,0,0,0,0,0,0,0,0,0
Medio_bajo,No_siniestro,427139,10,1369.07,0,0,0,0,0,0,0,0,0,0,0,0,0,0,0
Medio_bajo,No_siniestro,427780,44,697.92,0,0,0,0,0,0,0,0,0,0,0,0,0,0,0
Medio_bajo,No_siniestro,428488,66,2411.35,0,0,0,0,0,0,0,0,0,0,0,0,0,0,0
Medio_bajo,No_siniestro,428984,8,23.3,33317.27,0,0,0,0,0,0,0,0,0,0,0,0,0,0
Medio_bajo,No_siniestro,429316,43,2382.4,127012.17,0,0,0,0,0,0,0,0,0,0,0,0,0,0
Medio_bajo,No_siniestro,429519,119,251.68,0,0,0,0,0,0,1,1,0,0,0,0,0,0,0
Medio_bajo,No_siniestro,429763,76,846.38,27548.26,0,0,0,0,0,0,0,0,0,0,0,0,0,0
Medio_bajo,No_siniestro,429767,48,10610.38,39903.69,0,0,0,0,0,0,0,0,0,0,0,0,0,0
Medio_bajo,No_siniestro,429996,20,2968.64,0,0,0,0,0,0,0,0,0,0,0,0,0,0,0
Medio_bajo,No_siniestro,430148,11,191.09,0,0,0,0,0,0,0,0,0,0,0,0,0,0,0
Medio_bajo,No_siniestro,430160,44,3261.16,0,0,0,0,0,0,0,0,0,0,0,0,0,0,0
Medio_bajo,No_siniestro,430166,41,3229.71,0,0,0,0,0,0,0,0,0,0,0,0,0,0,0
Medio_bajo,No_siniestro,430573,33,0.05,0,0,0,0,0,0,1,1,0,0,0,0,0,0,0
Medio_bajo,Si_siniestro,431035,14,377.72,0,0,1,2,1,0,0,4,0,0,0,0,0,0,0
Medio_bajo,No_siniestro,431236,32,16.34,0,0,0,0,0,0,0,0,0,0,0,0,0,0,0
Medio_bajo,No_siniestro,433500,44,6937.08,0,0,0,0,0,0,0,0,0,0,0,0,0,0,0
Medio_bajo,No_siniestro,434095,44,4638.24,0,0,0,0,0,0,0,0,0,0,0,0,0,0,0
Medio_bajo,No_siniestro,434180,44,10073.76,0,0,0,0,0,0,0,0,0,0,0,0,0,0,0
Medio_bajo,No_siniestro,435520,44,227.16,0,0,0,0,0,0,0,0,0,0,0,0,0,0,0
Medio_bajo,No_siniestro,435676,32,560.38,0,0,0,0,0,0,0,0,0,0,0,0,0,0,0
Medio_bajo,Si_siniestro,435738,7,4975.33,0,1,0,0,0,0,0,1,0,0,0,0,0,0,0
Medio_bajo,Si_siniestro,437694,8,978.51,0,0,0,0,0,0,0,0,0,0,0,0,0,0,0
Medio_bajo,No_siniestro,437767,31,723.01,0,0,0,0,0,0,0,0,0,0,0,0,0,0,0
Medio_bajo,No_siniestro,438858,9,1447.89,0,0,0,0,0,0,0,0,0,0,0,0,0,0,0
Medio_bajo,No_siniestro,438939,8,40.67,59284.01,0,0,0,0,0,0,0,0,0,0,0,0,0,0
Medio_bajo,Si_siniestro,439324,50,3759.6,0,0,0,0,0,0,0,0,0,0,0,0,0,0,0
Medio_bajo,No_siniestro,439630,44,766.24,0,0,0,0,0,0,0,0,0,0,0,0,0,0,0
Medio_bajo,No_siniestro,441739,8,387.64,0,0,0,0,0,0,0,0,0,0,0,0,0,0,0
Medio_bajo,No_siniestro,445461,6,1211.15,0,0,0,0,0,0,0,0,0,0,0,0,0,0,0
Medio_bajo,No_siniestro,448056,84,321.99,0,0,0,0,0,0,0,0,0,0,0,0,0,0,0
Medio_bajo,No_siniestro,448209,122,1120.94,0,0,0,0,0,0,0,0,0,0,0,0,0,0,0
Medio_bajo,No_siniestro,448451,32,889.64,0,0,0,0,0,0,0,0,0,0,0,0,0,0,0
Medio_bajo,No_siniestro,448974,98,33.26,11097.38,0,0,0,0,0,0,0,0,0,0,0,0,0,0
Medio_bajo,No_siniestro,449418,227,7730.18,0,0,0,0,0,0,0,0,0,0,0,0,0,0,0
Medio_bajo,No_siniestro,449732,20,4649.42,0,1,1,1,1,0,0,4,0,0,0,0,0,0,0
Medio_bajo,No_siniestro,449954,96,1309.56,0,0,0,0,0,0,0,0,0,0,0,0,0,0,0
Medio_bajo,No_siniestro,450841,164,1029.09,0,0,0,0,0,0,0,0,0,0,0,0,0,0,0
Medio_bajo,No_siniestro,451564,48,604.32,0,0,0,0,0,0,0,0,0,0,0,0,0,0,0
Medio_bajo,No_siniestro,451654,79,53.42,0,0,0,0,0,0,0,0,0,0,0,0,0,0,0
Medio_bajo,No_siniestro,451829,59,2413.98,0,0,0,0,0,0,0,0,0,0,0,0,0,0,0
Medio_bajo,No_siniestro,452578,88,2631.09,0,0,0,0,0,0,0,0,0,0,0,0,0,0,0
Medio_bajo,No_siniestro,453325,45,73.36,0,0,0,0,0,0,0,0,0,0,0,0,0,0,0
Medio_bajo,No_siniestro,453421,99,5235.86,0,0,0,0,0,0,0,0,0,0,0,0,0,0,0
Medio_bajo,No_siniestro,453572,125,2391.18,0,0,0,0,0,0,0,0,0,0,0,0,0,0,0
Medio_bajo,No_siniestro,454430,44,6395.26,0,0,0,0,0,0,0,0,0,0,0,0,0,0,0
Medio_bajo,No_siniestro,454665,27,777.59,0,0,0,0,0,0,0,0,0,0,0,0,0,0,0
Medio_bajo,No_siniestro,454983,108,617.96,21762.8,0,0,0,0,0,0,0,0,0,0,0,0,0,0
Medio_bajo,No_siniestro,456061,117,4759.34,0,0,0,0,0,0,0,0,0,0,0,0,0,0,0
Medio_bajo,No_siniestro,456283,151,4311.51,0,0,0,0,0,0,0,0,0,0,0,0,0,0,0
Medio_bajo,No_siniestro,456709,61,521.66,0,0,0,0,0,0,0,0,0,0,0,0,0,0,0
Medio_bajo,No_siniestro,457241,183,8378,0,0,0,0,0,0,0,0,0,0,0,0,0,0,0
Medio_bajo,No_siniestro,457369,163,18490.59,0,0,0,0,0,0,0,0,0,0,0,0,0,0,0
Medio_bajo,No_siniestro,458118,45,190.08,0,0,0,0,0,0,0,0,0,0,0,0,0,0,0
Medio_bajo,No_siniestro,459285,124,3186.04,0,0,0,0,0,0,0,0,0,0,0,0,0,0,0
Medio_bajo,No_siniestro,459470,44,3195.99,0,0,0,0,0,0,0,0,0,0,0,0,0,0,0
Medio_bajo,No_siniestro,459592,82,7650.11,35906.65,0,0,0,0,0,0,0,0,0,0,0,0,0,0
Medio_bajo,No_siniestro,459874,131,108.78,0,0,0,0,1,0,0,1,0,0,0,0,0,0,0
Medio_bajo,No_siniestro,459892,11,316.18,0,0,0,0,0,0,0,0,0,0,0,0,0,0,0
Medio_bajo,No_siniestro,460633,182,1915.41,0,0,0,0,0,0,0,0,0,0,0,0,0,0,0
Medio_bajo,No_siniestro,461350,44,9961.79,0,0,0,0,0,0,0,0,0,0,0,0,0,0,0
Medio_bajo,No_siniestro,461856,6,1680.96,0,0,0,0,0,0,0,0,0,0,0,0,0,0,0
Medio_bajo,No_siniestro,462592,24,2707.89,0,0,0,0,0,1,0,1,0,0,0,0,0,0,0
Medio_bajo,No_siniestro,462681,6,9333.65,0,0,0,0,0,0,0,0,0,0,0,0,0,0,0
Medio_bajo,No_siniestro,463744,77,336.36,0,0,0,0,0,0,0,0,0,0,0,0,0,0,0
Medio_bajo,No_siniestro,464257,11,8660.58,0,0,0,0,0,0,0,0,0,0,0,0,0,0,0
Medio_bajo,No_siniestro,464463,33,1079.74,0,0,0,0,0,0,0,0,0,0,0,0,0,0,0
Medio_bajo,No_siniestro,464527,98,390.25,31114.47,0,0,0,0,0,0,0,0,0,0,0,0,0,0
Medio_bajo,No_siniestro,464600,40,271.42,0,0,0,0,1,0,0,1,0,0,0,0,0,0,0
Medio_bajo,No_siniestro,464720,40,122.68,63328.28,0,0,0,0,0,0,0,0,0,0,0,0,0,0
Medio_bajo,No_siniestro,465012,105,8660.61,0,0,0,0,0,0,0,0,0,0,0,0,0,0,0
Medio_bajo,No_siniestro,465073,6,15881.35,0,0,0,0,0,0,0,0,0,0,0,0,0,0,0
Medio_bajo,No_siniestro,465241,17,204.84,45057.9,0,0,0,0,0,0,0,0,0,0,0,0,0,0
Medio_bajo,Si_siniestro,465304,18,3431.45,0,0,7,6,5,4,3,25,0,0,0,0,0,0,0
Medio_bajo,Si_siniestro,465329,9,8349.19,0,1,0,0,0,0,0,1,0,0,0,0,0,0,0
Medio_bajo,No_siniestro,465489,156,220.56,0,0,0,0,0,0,0,0,0,0,0,0,0,0,0
Medio_bajo,No_siniestro,465743,131,10503.82,0,0,0,0,0,1,0,1,0,0,0,0,0,0,0
Medio_bajo,No_siniestro,466552,83,2468.08,0,0,0,0,0,0,0,0,0,0,0,0,0,0,0
Medio_bajo,No_siniestro,466874,153,13748.81,0,1,1,0,0,1,1,4,0,0,0,0,0,0,0
Medio_bajo,No_siniestro,467945,103,1611.72,0,0,0,0,0,0,0,0,0,0,0,0,0,0,0
Medio_bajo,No_siniestro,468042,51,5779.18,0,0,0,0,0,0,0,0,0,0,0,0,0,0,0
Medio_bajo,No_siniestro,468144,32,2722.07,0,0,0,0,0,0,0,0,0,0,0,0,0,0,0
Medio_bajo,No_siniestro,468209,88,7350.47,0,0,0,0,0,0,0,0,0,0,0,0,0,0,0
Medio_bajo,No_siniestro,468384,40,467.79,0,0,0,0,0,0,0,0,0,0,0,0,0,0,0
Medio_bajo,No_siniestro,469466,85,30.27,0,0,0,0,0,0,0,0,0,0,0,0,0,0,0
Medio_bajo,No_siniestro,469514,39,14647.85,0,0,0,0,0,0,1,1,0,0,0,0,0,0,0
Medio_bajo,No_siniestro,469668,55,478.08,0,0,0,0,0,0,0,0,0,0,0,0,0,0,0
Medio_bajo,No_siniestro,469810,40,11106.23,0,0,0,0,0,0,0,0,0,0,0,0,0,0,0
Medio_bajo,No_siniestro,469826,137,9216.87,0,0,0,0,0,0,0,0,0,0,0,0,0,0,0
Medio_bajo,No_siniestro,470515,42,111.21,0,0,0,0,0,0,0,0,0,0,0,0,0,0,0
Medio_bajo,No_siniestro,471242,82,329.99,0,0,0,0,0,0,0,0,0,0,0,0,0,0,0
Medio_bajo,No_siniestro,472317,25,805.25,0,0,0,0,0,0,0,0,0,0,0,0,0,0,0
Medio_bajo,No_siniestro,472846,34,630.44,0,0,0,0,0,0,0,0,0,0,0,0,0,0,0
Medio_bajo,No_siniestro,472871,29,1930.36,0,0,0,0,0,0,0,0,0,0,0,0,0,0,0
Medio_bajo,No_siniestro,472930,40,3048.59,0,0,0,0,0,0,0,0,0,0,0,0,0,0,0
Medio_bajo,No_siniestro,473016,17,8766,0,0,0,0,0,0,0,0,0,0,0,0,0,0,0
Medio_bajo,No_siniestro,473585,88,191.74,0,0,0,0,0,0,0,0,0,0,0,0,0,0,0
Medio_bajo,No_siniestro,473812,68,5948.56,0,0,0,0,0,0,0,0,0,0,0,0,0,0,0
Medio_bajo,No_siniestro,473901,42,2495.24,0,0,0,0,0,0,0,0,0,0,0,0,0,0,0
Medio_bajo,No_siniestro,474167,8,9160.49,0,0,0,0,0,0,0,0,0,0,0,0,0,0,0
Medio_bajo,No_siniestro,475270,40,2978.91,0,0,0,0,0,0,0,0,0,0,0,0,0,0,0
Medio_bajo,No_siniestro,475728,116,3281.63,0,0,0,0,0,0,0,0,0,0,0,0,0,0,0
Medio_bajo,No_siniestro,475908,8,196.8,0,0,1,0,0,0,0,1,0,0,0,0,0,0,0
Medio_bajo,No_siniestro,476364,90,1474.61,0,0,0,0,0,0,0,0,0,0,0,0,0,0,0
Medio_bajo,No_siniestro,476593,94,55.24,0,0,0,0,0,0,0,0,0,0,0,0,0,0,0
Medio_bajo,No_siniestro,478150,40,2119.6,27506.05,0,0,0,0,0,0,0,0,0,0,0,0,0,0
Medio_bajo,No_siniestro,478369,163,19525.52,0,0,0,0,0,0,0,0,0,0,0,0,0,0,0
Medio_bajo,No_siniestro,478644,56,574.51,0,0,0,0,0,0,0,0,0,0,0,0,0,0,0
Medio_bajo,No_siniestro,478942,85,1343.42,0,0,0,0,0,0,0,0,0,0,0,0,0,0,0
Medio_bajo,No_siniestro,479038,85,34.4,0,0,0,0,0,0,0,0,0,0,0,0,0,0,0
Medio_bajo,No_siniestro,479213,153,646.68,0,1,0,0,0,0,0,1,0,0,0,0,0,0,0
Medio_bajo,No_siniestro,479625,39,3679.29,26061.85,0,0,0,0,0,0,0,0,0,0,0,0,0,0
Medio_bajo,No_siniestro,480003,36,12186.18,50805.11,0,0,0,0,0,0,0,0,0,0,0,0,0,0
Medio_bajo,No_siniestro,482237,108,3245.57,0,0,1,0,1,0,0,2,0,0,0,0,0,0,0
Medio_bajo,No_siniestro,482492,59,166.68,0,1,0,0,1,0,1,3,0,0,0,0,0,0,0
Medio_bajo,No_siniestro,482844,29,481.55,0,0,0,0,0,0,0,0,0,0,0,0,0,0,0
Medio_bajo,No_siniestro,483409,117,436.29,0,0,0,0,0,0,0,0,0,0,0,0,0,0,0
Medio_bajo,No_siniestro,483808,92,1647.47,0,0,0,0,0,0,0,0,0,0,0,0,0,0,0
Medio_bajo,No_siniestro,484285,80,237.16,0,0,0,0,0,0,0,0,0,0,0,0,0,0,0
Medio_bajo,No_siniestro,484591,77,54.9,0,0,0,0,0,1,1,2,0,0,0,0,0,0,0
Medio_bajo,No_siniestro,484646,93,15293.72,0,0,0,0,0,0,0,0,0,0,0,0,0,0,0
Medio_bajo,No_siniestro,484933,16,258.89,0,0,0,0,0,0,0,0,0,0,0,0,0,0,0
Medio_bajo,No_siniestro,485703,92,669.53,0,0,0,0,0,0,0,0,0,0,0,0,0,0,0
Medio_bajo,No_siniestro,485792,85,2094.88,0,0,0,0,0,0,1,1,0,0,0,0,0,0,0
Medio_bajo,No_siniestro,486455,47,988.09,48696.08,0,0,0,0,0,0,0,0,0,0,0,0,0,0
Medio_bajo,No_siniestro,486467,55,4696.61,15638.09,0,0,0,0,0,0,0,0,0,0,0,0,0,0
Medio_bajo,No_siniestro,486706,17,2343.48,0,0,0,0,0,0,0,0,0,0,0,0,0,0,0
Medio_bajo,No_siniestro,487778,6,991.16,0,0,0,0,0,0,0,0,0,0,0,0,0,0,0
Medio_bajo,No_siniestro,488381,22,1667.06,0,0,0,0,0,0,0,0,0,0,0,0,0,0,0
Medio_bajo,No_siniestro,488754,37,3329.55,0,0,0,0,0,0,0,0,0,0,0,0,0,0,0
Medio_bajo,Si_siniestro,489025,7,980.39,16143.84,0,0,0,0,0,0,0,0,0,0,0,0,0,0
Medio_bajo,No_siniestro,490019,68,833.06,0,0,0,0,0,0,0,0,0,0,0,0,0,0,0
Medio_bajo,No_siniestro,490602,33,64.33,0,0,0,0,0,0,0,0,0,0,0,0,0,0,0
Medio_bajo,Si_siniestro,490714,10,1332.96,0,0,0,0,0,0,0,0,0,0,0,0,0,0,0
Medio_bajo,No_siniestro,490932,40,3281.78,0,0,0,0,0,0,0,0,0,0,0,0,0,0,0
Medio_bajo,No_siniestro,491520,40,2476.65,0,0,0,0,0,0,0,0,0,0,0,0,0,0,0
Medio_bajo,No_siniestro,491649,8,4370.64,51044.12,0,0,0,0,0,0,0,0,0,0,0,0,0,0
Medio_bajo,No_siniestro,493739,6,225.45,0,0,0,0,0,0,0,0,0,0,0,0,0,0,0
Medio_bajo,No_siniestro,494369,135,1181.96,0,0,0,0,0,0,0,0,0,0,0,0,0,0,0
Medio_bajo,No_siniestro,494388,47,5024.75,0,0,0,0,0,0,0,0,0,0,0,0,0,0,0
Medio_bajo,No_siniestro,494949,106,2016.18,0,0,0,0,0,0,0,0,0,0,0,0,0,0,0
Medio_bajo,No_siniestro,495990,40,1837.11,0,0,0,0,0,0,0,0,0,0,0,0,0,0,0
Medio_bajo,No_siniestro,496091,10,1268.25,0,0,0,0,0,0,0,0,0,0,0,0,0,0,0
Medio_bajo,No_siniestro,496103,10,2287.56,0,0,0,0,0,0,0,0,0,0,0,0,0,0,0
Medio_bajo,No_siniestro,496389,14,231.82,0,0,0,0,0,0,0,0,0,0,0,0,0,0,0
Medio_bajo,No_siniestro,496898,15,1480.93,0,0,0,0,0,0,0,0,0,0,0,0,0,0,0
Medio_bajo,No_siniestro,498072,28,182.52,0,0,0,0,0,0,0,0,0,0,0,0,0,0,0
Medio_bajo,No_siniestro,498184,10,57.89,0,0,0,0,0,0,0,0,0,0,0,0,0,0,0
Medio_bajo,No_siniestro,498920,40,1125.01,0,0,0,0,0,0,0,0,0,0,0,0,0,0,0
Medio_bajo,No_siniestro,499090,40,2262.73,0,0,0,0,0,0,0,0,0,0,0,0,0,0,0
Medio_bajo,No_siniestro,499125,68,11024.31,48689,0,0,0,0,0,0,0,0,0,0,0,0,0,0
Medio_bajo,No_siniestro,499353,46,1224.11,0,0,0,0,0,0,0,0,0,0,0,0,0,0,0
Medio_bajo,No_siniestro,500013,90,6079.93,0,0,0,0,0,0,0,0,0,0,0,0,0,0,0
Medio_bajo,No_siniestro,500632,11,1586.52,0,0,0,0,0,0,0,0,0,0,0,0,0,0,0
Medio_bajo,No_siniestro,503370,40,1267.1,0,0,0,0,0,0,0,0,0,0,0,0,0,0,0
Medio_bajo,No_siniestro,504805,99,384.39,0,0,0,0,0,0,0,0,0,0,0,0,0,0,0
Medio_bajo,No_siniestro,505310,40,1283.77,0,0,0,0,0,0,0,0,0,0,0,0,0,0,0
Medio_bajo,No_siniestro,509516,44,831,0,1,0,0,0,0,0,1,0,0,0,0,0,0,0
Medio_bajo,No_siniestro,509899,28,18435.65,0,0,0,0,0,0,0,0,0,0,0,0,0,0,0
Medio_bajo,Si_siniestro,511445,14,315.35,0,0,0,0,0,0,1,1,0,0,0,0,0,0,0
Medio_bajo,No_siniestro,511662,11,807.86,0,0,0,0,0,0,0,0,0,0,0,0,0,0,0
Medio_bajo,No_siniestro,512058,34,9605.03,0,0,0,0,0,0,0,0,0,0,0,0,0,0,0
Medio_bajo,No_siniestro,512230,40,1537.89,0,0,0,0,0,0,0,0,0,0,0,0,0,0,0
Medio_bajo,No_siniestro,514257,122,3724.61,0,0,0,0,0,0,0,0,0,0,0,0,0,0,0
Medio_bajo,No_siniestro,514653,66,300,0,0,0,0,0,0,0,0,0,0,0,0,0,0,0
Medio_bajo,No_siniestro,514716,16,826.15,0,0,0,0,0,0,0,0,0,0,0,0,0,0,0
Medio_bajo,No_siniestro,514720,40,5587.94,0,0,0,0,0,0,1,1,0,0,0,0,0,0,0
Medio_bajo,No_siniestro,515000,40,597.41,0,0,0,0,0,0,0,0,0,0,0,0,0,0,0
Medio_bajo,No_siniestro,515110,40,273.96,0,0,0,0,0,0,0,0,0,0,0,0,0,0,0
Medio_bajo,No_siniestro,515504,35,2.1,0,0,0,0,0,0,0,0,0,0,0,0,0,0,0
Medio_bajo,No_siniestro,515600,40,218.2,0,0,0,0,0,0,0,0,0,0,0,0,0,0,0
Medio_bajo,No_siniestro,515707,116,1113.31,0,0,0,0,0,0,0,0,0,0,0,0,0,0,0
Medio_bajo,No_siniestro,515738,162,12812.65,0,0,0,0,0,0,0,0,0,0,0,0,0,0,0
Medio_bajo,No_siniestro,515782,123,2202.36,0,0,1,1,1,0,0,3,0,0,0,0,0,0,0
Medio_bajo,No_siniestro,515906,110,1102.75,0,0,0,0,0,0,0,0,0,0,0,0,0,0,0
Medio_bajo,No_siniestro,515933,105,12.81,0,0,0,0,0,0,0,0,0,0,0,0,0,0,0
Medio_bajo,No_siniestro,516093,11,2332.41,0,0,0,0,0,0,0,0,0,0,0,0,0,0,0
Medio_bajo,No_siniestro,516974,179,618.42,0,0,0,0,0,0,0,0,0,0,0,0,0,0,0
Medio_bajo,No_siniestro,517021,113,8388.93,31591.82,0,0,0,0,0,0,0,0,0,0,0,0,0,0
Medio_bajo,No_siniestro,517351,40,1691.08,0,0,0,0,0,0,0,0,0,0,0,0,0,0,0
Medio_bajo,No_siniestro,517424,175,4628.9,0,0,0,0,0,0,0,0,0,0,0,0,0,0,0
Medio_bajo,No_siniestro,517564,64,443.66,0,0,0,0,0,0,0,0,0,0,0,0,0,0,0
Medio_bajo,No_siniestro,518006,100,81.71,0,0,0,0,0,0,0,0,0,0,0,0,0,0,0
Medio_bajo,Si_siniestro,518348,7,905.07,0,0,0,0,0,0,0,0,0,0,0,0,0,0,0
Medio_bajo,No_siniestro,519141,49,1784.05,0,0,0,0,1,0,0,1,0,0,0,0,0,0,0
Medio_bajo,No_siniestro,520282,117,9245.97,0,0,0,0,0,0,0,0,0,0,0,0,0,0,0
Medio_bajo,No_siniestro,520762,56,8252.96,0,0,0,0,0,0,0,0,0,0,0,0,0,0,0
Medio_bajo,No_siniestro,520776,82,36.56,0,0,0,0,0,0,0,0,0,0,0,0,0,0,0
Medio_bajo,No_siniestro,521137,23,293.34,0,0,0,0,0,0,0,0,0,0,0,0,0,0,0
Medio_bajo,No_siniestro,521225,19,11339.89,0,0,0,0,0,0,0,0,0,0,0,0,0,0,0
Medio_bajo,No_siniestro,521497,45,1620.54,0,0,0,0,0,0,0,0,0,0,0,0,0,0,0
Medio_bajo,No_siniestro,521821,62,23332.5,0,0,0,0,0,0,0,0,0,0,0,0,0,0,0
Medio_bajo,No_siniestro,521884,157,0.01,0,0,0,0,0,0,0,0,0,0,0,0,0,0,0
Medio_bajo,No_siniestro,522140,40,6254.98,0,0,0,0,0,0,0,0,0,0,0,0,0,0,0
Medio_bajo,No_siniestro,523067,130,193.97,0,0,0,0,0,0,0,0,0,0,0,0,0,0,0
Medio_bajo,No_siniestro,523185,136,608.33,0,0,0,0,0,0,0,0,0,0,0,0,0,0,0
Medio_bajo,No_siniestro,523322,59,714.27,0,0,0,0,0,0,0,0,0,0,0,0,0,0,0
Medio_bajo,No_siniestro,523326,48,10097.3,0,0,0,0,0,0,0,0,0,0,0,0,0,0,0
Medio_bajo,No_siniestro,523543,9,4.08,0,0,0,0,0,0,0,0,0,0,0,0,0,0,0
Medio_bajo,No_siniestro,524285,48,1317.99,23109.66,0,0,0,0,0,0,0,0,0,0,0,0,0,0
Medio_bajo,No_siniestro,524482,113,1416.91,0,0,0,0,0,0,0,0,0,0,0,0,0,0,0
Medio_bajo,No_siniestro,525719,63,1908.26,0,0,0,0,0,0,0,0,0,0,0,0,0,0,0
Medio_bajo,No_siniestro,525791,164,827.08,0,0,0,0,0,0,0,0,0,0,0,0,0,0,0
Medio_bajo,No_siniestro,526018,12,20751.46,0,0,0,0,0,0,0,0,0,0,0,0,0,0,0
Medio_bajo,No_siniestro,526420,40,10653.15,65444.17,0,0,0,0,0,0,0,0,0,0,0,0,0,0
Medio_bajo,No_siniestro,526558,50,5109.31,0,0,0,0,0,0,0,0,0,0,0,0,0,0,0
Medio_bajo,No_siniestro,526957,9,21113.98,0,0,0,0,0,0,0,0,0,0,0,0,0,0,0
Medio_bajo,No_siniestro,527334,29,6925.12,0,0,0,0,0,0,0,0,0,0,0,0,0,0,0
Medio_bajo,No_siniestro,528331,99,0.05,0,0,0,0,0,0,0,0,0,0,0,0,0,0,0
Medio_bajo,No_siniestro,528526,76,7337.57,0,0,0,0,0,0,0,0,0,0,0,0,0,0,0
Medio_bajo,No_siniestro,528545,95,561.61,0,0,0,0,0,0,0,0,0,0,0,0,0,0,0
Medio_bajo,No_siniestro,529040,40,940.77,0,0,0,0,0,0,0,0,0,0,0,0,0,0,0
Medio_bajo,No_siniestro,530301,177,199.57,0,0,0,0,0,0,0,0,0,0,0,0,0,0,0
Medio_bajo,No_siniestro,530461,45,1247.94,0,0,0,0,0,0,0,0,0,0,0,0,0,0,0
Medio_bajo,No_siniestro,530896,52,3163.96,0,0,0,0,0,0,0,0,0,0,0,0,0,0,0
Medio_bajo,No_siniestro,531109,51,2362.15,0,0,0,0,0,0,0,0,0,0,0,0,0,0,0
Medio_bajo,No_siniestro,531246,10,2780.56,0,0,0,0,0,0,0,0,0,0,0,0,0,0,0
Medio_bajo,No_siniestro,531840,40,3157.64,0,0,0,0,0,0,0,0,0,0,0,0,0,0,0
Medio_bajo,No_siniestro,532016,39,750.48,0,0,0,0,0,0,0,0,0,0,0,0,0,0,0
Medio_bajo,No_siniestro,532924,126,795.22,0,0,0,0,0,0,0,0,0,0,0,0,0,0,0
Medio_bajo,No_siniestro,533176,94,6091.44,0,0,0,0,0,0,0,0,0,0,0,0,0,0,0
Medio_bajo,No_siniestro,533553,87,14563.18,0,0,0,0,0,0,0,0,0,0,0,0,0,0,0
Medio_bajo,No_siniestro,534696,74,2352.16,0,0,0,0,0,0,0,0,0,0,0,0,0,0,0
Medio_bajo,No_siniestro,534731,16,1122.22,0,0,0,0,0,0,0,0,0,0,0,0,0,0,0
Medio_bajo,No_siniestro,534995,83,9332.45,0,0,0,1,0,0,0,1,0,0,0,0,0,0,0
Medio_bajo,No_siniestro,535152,7,8807.77,0,0,1,0,1,0,0,2,0,0,0,0,0,0,0
Medio_bajo,No_siniestro,535237,119,2511.56,0,0,0,0,0,0,0,0,0,0,0,0,0,0,0
Medio_bajo,No_siniestro,536442,52,541.47,42889.57,0,0,0,0,0,0,0,0,0,0,0,0,0,0
Medio_bajo,No_siniestro,537452,6,6173.02,0,1,1,0,0,0,0,2,0,0,0,0,0,0,0
Medio_bajo,No_siniestro,537784,108,3632.63,0,0,0,0,0,0,0,0,0,0,0,0,0,0,0
Medio_bajo,No_siniestro,538147,111,362.55,0,0,0,0,0,0,0,0,0,0,0,0,0,0,0
Medio_bajo,No_siniestro,538939,84,1154.04,0,0,0,0,0,0,0,0,0,0,0,0,0,0,0
Medio_bajo,No_siniestro,539035,16,12864.84,0,0,0,0,0,0,0,0,0,0,0,0,0,0,0
Medio_bajo,No_siniestro,539666,51,4590.03,0,0,0,0,0,0,0,0,0,0,0,0,0,0,0
Medio_bajo,No_siniestro,539819,15,6746.18,0,0,0,0,0,0,0,0,0,0,0,0,0,0,0
Medio_bajo,No_siniestro,540206,25,7530.27,0,0,0,0,0,0,0,0,0,0,0,0,0,0,0
Medio_bajo,No_siniestro,540506,148,2097.23,0,0,0,0,0,0,0,0,0,0,0,0,0,0,0
Medio_bajo,No_siniestro,540841,33,1272.61,0,0,0,0,0,0,1,1,0,0,0,0,0,0,0
Medio_bajo,No_siniestro,541270,40,467.38,0,0,0,0,0,0,0,0,0,0,0,0,0,0,0
Medio_bajo,Si_siniestro,542265,35,1604.45,0,0,0,0,0,0,0,0,0,0,0,0,0,0,0
Medio_bajo,No_siniestro,542458,163,13259.65,0,0,0,0,0,0,0,0,0,0,0,0,0,0,0
Medio_bajo,No_siniestro,542535,118,557.59,0,0,0,0,0,0,0,0,0,0,0,0,0,0,0
Medio_bajo,No_siniestro,542989,7,2854.35,0,0,0,0,0,0,0,0,0,0,0,0,0,0,0
Medio_bajo,No_siniestro,544145,28,2854.88,0,0,0,0,0,0,0,0,0,0,0,0,0,0,0
Medio_bajo,No_siniestro,544207,51,392.3,0,0,0,0,0,0,0,0,0,0,0,0,0,0,0
Medio_bajo,Si_siniestro,544470,40,1405.2,0,0,0,0,0,0,0,0,0,0,0,0,0,0,0
Medio_bajo,No_siniestro,544487,98,4343.27,0,0,0,0,0,0,0,0,0,0,0,0,0,0,0
Medio_bajo,No_siniestro,545450,40,2297.62,0,0,0,0,0,0,0,0,0,0,0,0,0,0,0
Medio_bajo,No_siniestro,545557,65,76.67,0,0,0,0,0,0,0,0,0,0,0,0,0,0,0
Medio_bajo,No_siniestro,545787,108,1175.4,0,0,0,0,0,0,0,0,0,0,0,0,0,0,0
Medio_bajo,No_siniestro,545975,11,0.27,0,0,0,0,0,0,0,0,0,0,0,0,0,0,0
Medio_bajo,No_siniestro,546104,7,510.38,0,0,0,0,0,0,0,0,0,0,0,0,0,0,0
Medio_bajo,Si_siniestro,546116,16,12246.56,50036.73,0,0,0,0,0,0,0,0,0,0,0,0,0,0
Medio_bajo,No_siniestro,547471,62,813.31,0,0,0,0,0,0,0,0,0,0,0,0,0,0,0
Medio_bajo,No_siniestro,547677,54,650.45,0,0,0,0,0,0,0,0,0,0,0,0,0,0,0
Medio_bajo,No_siniestro,547943,78,5.89,0,0,0,0,0,0,0,0,0,0,0,0,0,0,0
Medio_bajo,No_siniestro,548432,10,37.94,18232.77,0,0,0,0,0,0,0,0,0,0,0,0,0,0
Medio_bajo,No_siniestro,548667,64,4097.19,0,0,0,0,0,0,0,0,0,0,0,0,0,0,0
Medio_bajo,No_siniestro,548917,187,568.43,0,0,0,0,0,0,0,0,0,0,0,0,0,0,0
Medio_bajo,No_siniestro,549491,30,1993.67,0,0,0,0,0,0,0,0,0,0,0,0,0,0,0
Medio_bajo,No_siniestro,549584,121,632.99,0,0,0,0,0,0,0,0,0,0,0,0,0,0,0
Medio_bajo,No_siniestro,549962,39,6141.21,0,0,0,0,0,0,0,0,0,0,0,0,0,0,0
Medio_bajo,No_siniestro,550043,186,2377.36,0,0,0,0,0,0,0,0,0,0,0,0,0,0,0
Medio_bajo,No_siniestro,550345,111,35778.28,86283.91,0,0,0,0,0,0,0,0,0,0,0,0,0,0
Medio_bajo,No_siniestro,550485,68,3320.76,0,0,0,0,0,0,0,0,0,0,0,0,0,0,0
Medio_bajo,No_siniestro,550878,81,644.42,0,0,0,0,0,0,0,0,0,0,0,0,0,0,0
Medio_bajo,No_siniestro,551283,60,965.42,0,0,0,0,0,0,0,0,0,0,0,0,0,0,0
Medio_bajo,No_siniestro,551481,13,731.45,0,0,0,0,0,0,0,0,0,0,0,0,0,0,0
Medio_bajo,No_siniestro,551732,24,9396.01,0,0,0,0,0,0,0,0,0,0,0,0,0,0,0
Medio_bajo,No_siniestro,551945,43,4198.84,0,0,0,0,0,0,0,0,0,0,0,0,0,0,0
Medio_bajo,No_siniestro,552271,7,6651.7,0,0,0,0,0,0,0,0,0,0,0,0,0,0,0
Medio_bajo,No_siniestro,552651,29,4748.22,0,0,0,0,0,0,0,0,0,0,0,0,0,0,0
Medio_bajo,No_siniestro,553036,11,572.56,0,0,0,0,0,0,0,0,0,0,0,0,0,0,0
Medio_bajo,No_siniestro,553265,43,1228.38,0,0,0,0,0,0,0,0,0,0,0,0,0,0,0
Medio_bajo,No_siniestro,553410,40,1654.23,0,0,0,0,0,0,0,0,0,0,0,0,0,0,0
Medio_bajo,No_siniestro,553833,62,20325.07,64474.56,0,0,0,0,0,0,0,0,0,0,0,0,0,0
Medio_bajo,No_siniestro,555324,79,9944.17,73785.29,0,0,0,0,0,0,0,0,0,0,0,0,0,0
Medio_bajo,No_siniestro,555344,20,400.48,0,0,0,0,0,0,0,0,0,0,0,0,0,0,0
Medio_bajo,No_siniestro,555997,18,143.1,0,0,0,0,0,0,0,0,0,0,0,0,0,0,0
Medio_bajo,No_siniestro,556775,71,7826.85,51809.31,0,0,0,0,0,0,0,0,0,0,0,0,0,0
Medio_bajo,No_siniestro,557233,25,8542.61,0,0,0,0,0,0,0,0,0,0,0,0,0,0,0
Medio_bajo,No_siniestro,557512,33,2766.62,0,0,0,0,0,0,0,0,0,0,0,0,0,0,0
Medio_bajo,No_siniestro,558283,16,251.96,0,0,0,0,0,0,0,0,0,0,0,0,0,0,0
Medio_bajo,No_siniestro,558327,9,4750.85,0,0,0,0,0,0,0,0,0,0,0,0,0,0,0
Medio_bajo,No_siniestro,559076,66,922.77,0,0,0,0,0,0,0,0,0,0,0,0,0,0,0
Medio_bajo,No_siniestro,560683,123,11466.16,20395.1,0,0,0,0,0,0,0,0,0,0,0,0,0,0
Medio_bajo,No_siniestro,561553,6,3319.61,0,0,0,0,0,0,0,0,0,0,0,0,0,0,0
Medio_bajo,No_siniestro,561913,97,264.98,0,0,0,0,0,0,0,0,0,0,0,0,0,0,0
Medio_bajo,No_siniestro,563038,13,3738.81,0,0,0,0,0,0,0,0,0,0,0,0,0,0,0
Medio_bajo,No_siniestro,563155,94,4835.9,0,0,0,0,0,0,0,0,0,0,0,0,0,0,0
Medio_bajo,No_siniestro,563575,31,13242.22,0,0,0,0,0,0,0,0,0,0,0,0,0,0,0
Medio_bajo,No_siniestro,563602,43,15782.52,66308.81,0,0,0,0,0,0,0,0,0,0,0,0,0,0
Medio_bajo,No_siniestro,563763,35,1901.34,0,0,0,0,0,0,0,0,0,0,0,0,0,0,0
Medio_bajo,No_siniestro,563936,45,4980.85,0,0,0,0,0,0,0,0,0,0,0,0,0,0,0
Medio_bajo,No_siniestro,564258,68,12569.89,0,0,0,0,0,0,0,0,0,0,0,0,0,0,0
Medio_bajo,No_siniestro,564712,86,80.09,0,0,0,0,0,0,0,0,0,0,0,0,0,0,0
Medio_bajo,No_siniestro,565602,20,12398.78,0,0,0,0,0,0,0,0,0,0,0,0,0,0,0
Medio_bajo,No_siniestro,565634,99,1645.98,0,1,1,0,0,1,0,3,0,0,0,0,0,0,0
Medio_bajo,No_siniestro,566075,14,5739.22,0,0,0,0,0,0,0,0,0,0,0,0,0,0,0
Medio_bajo,Si_siniestro,566211,11,2417.33,0,0,0,0,0,0,0,0,0,0,0,0,0,0,0
Medio_bajo,No_siniestro,568532,32,53.01,0,0,0,0,0,0,0,0,0,0,0,0,0,0,0
Medio_bajo,No_siniestro,568596,7,307.95,0,0,0,0,0,0,0,0,0,0,0,0,0,0,0
Medio_bajo,No_siniestro,568717,19,91.43,0,0,0,0,0,0,0,0,0,0,0,0,0,0,0
Medio_bajo,No_siniestro,568933,76,3438.61,0,0,0,0,0,0,0,0,0,0,0,0,0,0,0
Medio_bajo,No_siniestro,568958,20,1.63,0,0,0,0,0,0,0,0,0,0,0,0,0,0,0
Medio_bajo,No_siniestro,569926,17,424.17,0,0,0,0,0,0,0,0,0,0,0,0,0,0,0
Medio_bajo,No_siniestro,570122,9,6503.38,0,0,0,0,0,0,0,0,0,0,0,0,0,0,0
Medio_bajo,No_siniestro,570186,48,3484,30039.39,0,0,0,0,0,0,0,0,0,0,0,0,0,0
Medio_bajo,No_siniestro,570418,39,15.86,0,2,1,0,0,0,0,3,0,0,0,0,0,0,0
Medio_bajo,No_siniestro,573748,23,1048.43,0,0,0,0,0,0,0,0,0,0,0,0,0,0,0
Medio_bajo,No_siniestro,575663,38,2454.12,0,0,1,0,0,0,0,1,0,0,0,0,0,0,0
Medio_bajo,No_siniestro,577631,91,1434.28,0,0,0,0,0,0,0,0,0,0,0,0,0,0,0
Medio_bajo,No_siniestro,577785,12,563.92,0,0,0,0,0,0,0,0,0,0,0,0,0,0,0
Medio_bajo,No_siniestro,577795,72,6958.54,0,0,0,0,0,0,0,0,0,0,0,0,0,0,0
Medio_bajo,No_siniestro,578272,62,318.23,0,0,1,1,0,0,0,2,0,0,0,0,0,0,0
Medio_bajo,No_siniestro,578286,18,204,0,0,0,0,0,0,0,0,0,0,0,0,0,0,0
Medio_bajo,No_siniestro,578691,24,884.76,0,0,0,0,0,0,0,0,0,0,0,0,0,0,0
Medio_bajo,No_siniestro,579688,30,3736.37,0,0,0,0,0,0,0,0,0,0,0,0,0,0,0
Medio_bajo,No_siniestro,580349,19,1502.35,0,0,0,0,0,0,0,0,0,0,0,0,0,0,0
Medio_bajo,No_siniestro,581177,33,3678.4,0,0,0,0,0,0,0,0,0,0,0,0,0,0,0
Medio_bajo,No_siniestro,581461,125,277.05,0,0,0,0,0,0,0,0,0,0,0,0,0,0,0
Medio_bajo,No_siniestro,581546,104,5769.47,0,0,0,0,0,0,0,0,0,0,0,0,0,0,0
Medio_bajo,No_siniestro,582698,125,458.83,0,0,0,0,0,0,0,0,0,0,0,0,0,0,0
Medio_bajo,No_siniestro,583106,66,2224.48,0,0,0,0,0,0,0,0,0,0,0,0,0,0,0
Medio_bajo,No_siniestro,583503,128,607.83,0,0,0,0,0,0,0,0,0,0,0,0,0,0,0
Medio_bajo,No_siniestro,583689,81,557.95,0,0,7,7,7,7,7,35,0,0,0,0,0,0,0
Medio_bajo,No_siniestro,584125,137,3483.64,0,0,0,0,0,0,0,0,0,0,0,0,0,0,0
Medio_bajo,No_siniestro,584799,32,15156.69,0,0,0,0,0,0,0,0,0,0,0,0,0,0,0
Medio_bajo,No_siniestro,585196,111,276.31,0,0,0,0,0,0,0,0,0,0,0,0,0,0,0
Medio_bajo,No_siniestro,585251,159,5012.29,0,1,0,0,0,0,0,1,0,0,0,0,0,0,0
Medio_bajo,No_siniestro,585287,137,238.8,0,0,0,0,0,0,0,0,0,0,0,0,0,0,0
Medio_bajo,No_siniestro,585657,64,0.03,0,0,0,0,0,0,0,0,0,0,0,0,0,0,0
Medio_bajo,No_siniestro,585671,55,2231.99,0,0,0,0,0,0,0,0,0,0,0,0,0,0,0
Medio_bajo,No_siniestro,586354,98,778.36,0,0,0,0,0,0,0,0,0,0,0,0,0,0,0
Medio_bajo,No_siniestro,587689,108,3284.28,47911.74,0,0,0,0,0,0,0,0,0,0,0,0,0,0
Medio_bajo,No_siniestro,587875,90,601.57,0,0,0,0,0,0,0,0,0,0,0,0,0,0,0
Medio_bajo,No_siniestro,588044,14,3299.88,0,0,0,0,0,0,0,0,0,0,0,0,0,0,0
Medio_bajo,No_siniestro,588198,34,2331.53,0,0,0,0,0,0,0,0,0,0,0,0,0,0,0
Medio_bajo,No_siniestro,588427,89,1313.6,0,0,0,7,7,7,7,28,0,0,0,0,0,0,0
Medio_bajo,No_siniestro,588698,65,3010.41,59817.09,0,0,0,0,0,0,0,0,0,0,0,0,0,0
Medio_bajo,No_siniestro,588711,122,3753.78,0,0,0,0,0,0,0,0,0,0,0,0,0,0,0
Medio_bajo,No_siniestro,589101,38,459.49,0,0,0,0,0,0,0,0,0,0,0,0,0,0,0
Medio_bajo,No_siniestro,590494,33,2325.67,0,0,0,0,0,0,0,0,0,0,0,0,0,0,0
Medio_bajo,No_siniestro,591025,91,6555.75,0,0,0,0,0,0,0,0,0,0,0,0,0,0,0
Medio_bajo,No_siniestro,591095,185,4214.29,0,0,0,0,0,0,0,0,0,0,0,0,0,0,0
Medio_bajo,No_siniestro,592073,125,233.88,0,0,0,0,0,0,0,0,0,0,0,0,0,0,0
Medio_bajo,No_siniestro,592135,228,13765.87,0,0,0,0,0,0,0,0,0,0,0,0,0,0,0
Medio_bajo,No_siniestro,592526,33,2168.12,0,0,0,0,0,0,0,0,0,0,0,0,0,0,0
Medio_bajo,No_siniestro,592953,60,14092.12,0,0,0,0,0,0,1,1,0,0,0,0,0,0,0
Medio_bajo,No_siniestro,593439,81,5294.53,0,0,0,0,0,0,0,0,0,0,0,0,0,0,0
Medio_bajo,No_siniestro,594669,41,1510.53,0,0,0,0,0,0,0,0,0,0,0,0,0,0,0
Medio_bajo,No_siniestro,595087,106,1718.51,0,0,0,0,0,0,0,0,0,0,0,0,0,0,0
Medio_bajo,No_siniestro,595117,34,6104.67,0,0,0,0,0,0,0,0,0,0,0,0,0,0,0
Medio_bajo,No_siniestro,595142,7,4227.06,0,0,0,0,0,0,0,0,0,0,0,0,0,0,0
Medio_bajo,No_siniestro,595342,41,666.61,0,0,0,0,0,0,0,0,0,0,0,0,0,0,0
Medio_bajo,No_siniestro,595677,175,891.63,0,0,0,0,0,0,0,0,0,0,0,0,0,0,0
Medio_bajo,No_siniestro,596254,118,4479.4,0,0,0,0,0,0,0,0,0,0,0,0,0,0,0
Medio_bajo,No_siniestro,596384,169,3848.48,0,0,0,0,0,0,0,0,0,0,0,0,0,0,0
Medio_bajo,No_siniestro,596405,70,935.77,0,0,0,0,0,1,1,2,0,0,0,0,0,0,0
Medio_bajo,No_siniestro,596437,123,11179.01,0,0,0,0,0,0,0,0,0,0,0,0,0,0,0
Medio_bajo,No_siniestro,596688,16,14215.53,0,0,0,0,0,0,0,0,0,0,0,0,0,0,0
Medio_bajo,No_siniestro,597449,93,171.41,0,0,0,0,0,0,0,0,0,0,0,0,0,0,0
Medio_bajo,No_siniestro,597591,6,1600.95,0,0,0,0,0,0,0,0,0,0,0,0,0,0,0
Medio_bajo,No_siniestro,598143,31,3315.61,0,0,0,0,0,0,0,0,0,0,0,0,0,0,0
Medio_bajo,No_siniestro,598296,73,2743.74,0,0,0,0,0,0,0,0,0,0,0,0,0,0,0
Medio_bajo,No_siniestro,598615,172,17960.8,153078.27,0,0,0,0,0,0,0,0,0,0,0,0,0,0
Medio_bajo,No_siniestro,598915,156,1106.44,0,0,0,0,0,0,0,0,0,0,0,0,0,0,0
Medio_bajo,No_siniestro,599363,35,14518.89,0,0,0,0,0,0,0,0,0,0,0,0,0,0,0
Medio_bajo,No_siniestro,600268,124,7844.38,0,0,0,0,0,0,0,0,0,0,0,0,0,0,0
Medio_bajo,No_siniestro,600523,62,854.92,0,0,0,0,0,0,0,0,0,0,0,0,0,0,0
Medio_bajo,No_siniestro,600987,48,3391.83,0,0,0,0,0,0,0,0,0,0,0,0,0,0,0
Medio_bajo,No_siniestro,601064,77,923.9,0,0,0,0,0,0,0,0,0,0,0,0,0,0,0
Medio_bajo,No_siniestro,601075,80,2259.74,0,0,0,0,0,0,0,0,0,0,0,0,0,0,0
Medio_bajo,No_siniestro,601287,7,953.94,0,0,0,0,1,1,0,2,0,0,0,0,0,0,0
Medio_bajo,No_siniestro,601742,10,6622.67,0,0,0,0,0,0,0,0,0,0,0,0,0,0,0
Medio_bajo,No_siniestro,602297,26,729.68,0,1,0,0,0,0,1,2,0,0,0,0,0,0,0
Medio_bajo,No_siniestro,602847,22,252.3,0,0,0,0,0,0,0,0,0,0,0,0,0,0,0
Medio_bajo,No_siniestro,603871,9,3895.85,0,0,0,0,0,0,0,0,0,0,0,0,0,0,0
Medio_bajo,No_siniestro,604842,18,8254.45,0,0,0,0,0,0,0,0,0,0,0,0,0,0,0
Medio_bajo,No_siniestro,605087,35,1959.45,0,0,0,0,0,0,0,0,0,0,0,0,0,0,0
Medio_bajo,No_siniestro,605547,45,1888.52,0,0,0,0,0,0,0,0,0,0,0,0,0,0,0
Medio_bajo,No_siniestro,605662,10,10215.13,0,0,0,0,0,0,0,0,0,0,0,0,0,0,0
Medio_bajo,No_siniestro,607049,83,8681.75,0,0,0,0,0,0,0,0,0,0,0,0,0,0,0
Medio_bajo,No_siniestro,608409,83,5454.93,0,0,0,0,0,0,0,0,0,0,0,0,0,0,0
Medio_bajo,No_siniestro,609464,31,388.58,0,0,0,0,0,0,0,0,0,0,0,0,0,0,0
Medio_bajo,No_siniestro,609877,101,3677.16,52902.4,0,2,0,0,0,0,2,0,0,0,0,0,0,0
Medio_bajo,No_siniestro,609944,10,474.2,0,0,0,0,0,0,0,0,0,0,0,0,0,0,0
Medio_bajo,No_siniestro,609965,74,7604.27,40776.7,0,0,0,0,0,0,0,0,0,0,0,0,0,0
Medio_bajo,No_siniestro,609968,91,0.18,0,0,0,0,0,0,0,0,0,0,0,0,0,0,0
Medio_bajo,No_siniestro,610213,45,2654.61,0,0,0,0,0,0,0,0,0,0,0,0,0,0,0
Medio_bajo,No_siniestro,610331,95,5084.23,42937.63,0,0,0,0,0,0,0,0,0,0,0,0,0,0
Medio_bajo,No_siniestro,611324,20,5346.65,0,0,0,0,0,0,0,0,0,0,0,0,0,0,0
Medio_bajo,No_siniestro,611545,58,808.79,0,0,0,0,0,0,0,0,0,0,0,0,0,0,0
Medio_bajo,No_siniestro,611699,26,1192.65,0,0,0,0,0,0,0,0,0,0,0,0,0,0,0
Medio_bajo,No_siniestro,612379,119,2086.83,0,0,0,0,0,0,0,0,0,0,0,0,0,0,0
Medio_bajo,No_siniestro,614415,76,1467.85,0,0,0,0,0,0,0,0,0,0,0,0,0,0,0
Medio_bajo,No_siniestro,614500,40,11466.49,56307.44,0,0,0,0,0,0,0,0,0,0,0,0,0,0
Medio_bajo,No_siniestro,615226,10,193.69,78343.63,0,0,0,0,0,0,0,0,0,0,0,0,0,0
Medio_bajo,Si_siniestro,615382,24,4994.91,0,0,0,0,0,0,0,0,0,0,0,0,0,0,0
Medio_bajo,No_siniestro,615929,34,737.14,0,0,0,0,0,0,0,0,0,0,0,0,0,0,0
Medio_bajo,No_siniestro,616211,30,331.85,0,0,0,0,0,0,0,0,0,0,0,0,0,0,0
Medio_bajo,No_siniestro,616588,26,2763.59,0,0,0,0,0,0,0,0,0,0,0,0,0,0,0
Medio_bajo,No_siniestro,616658,10,1029.96,0,1,0,0,0,0,0,1,0,0,0,0,0,0,0
Medio_bajo,No_siniestro,616781,9,4258.89,46394.79,0,0,0,0,0,0,0,0,0,0,0,0,0,0
Medio_bajo,No_siniestro,616796,89,1230.2,0,0,0,0,0,0,0,0,0,0,0,0,0,0,0
Medio_bajo,No_siniestro,616961,89,2976.86,0,0,0,0,0,0,0,0,0,0,0,0,0,0,0
Medio_bajo,No_siniestro,617084,169,1062.7,0,0,0,1,0,0,0,1,0,0,0,0,0,0,0
Medio_bajo,No_siniestro,617446,73,16847.24,41461.36,0,0,0,0,0,0,0,0,0,0,0,0,0,0
Medio_bajo,No_siniestro,617740,40,206.73,0,0,0,0,0,0,0,0,0,0,0,0,0,0,0
Medio_bajo,No_siniestro,617979,65,2306.03,0,0,0,0,0,0,0,0,0,0,0,0,0,0,0
Medio_bajo,No_siniestro,618086,100,3.83,0,0,0,0,0,0,0,0,0,0,0,0,0,0,0
Medio_bajo,No_siniestro,618087,74,5060.88,0,0,0,0,0,0,0,0,0,0,0,0,0,0,0
Medio_bajo,No_siniestro,618265,63,2114.27,0,0,0,0,0,0,0,0,0,0,0,0,0,0,0
Medio_bajo,No_siniestro,618717,139,7093.2,39863.69,0,0,0,0,0,0,0,0,0,0,0,0,0,0
Medio_bajo,No_siniestro,618996,13,1728.52,0,1,0,0,0,0,0,1,0,0,0,0,0,0,0
Medio_bajo,No_siniestro,619642,115,13738.25,0,0,0,0,0,0,0,0,0,0,0,0,0,0,0
Medio_bajo,No_siniestro,619824,13,480.81,20502.42,0,0,0,0,0,0,0,0,0,0,0,0,0,0
Medio_bajo,No_siniestro,619909,30,392.87,33066.41,0,0,0,0,0,0,0,0,0,0,0,0,0,0
Medio_bajo,No_siniestro,620450,40,946.36,0,0,0,0,0,0,0,0,0,0,0,0,0,0,0
Medio_bajo,No_siniestro,620957,33,5981.18,0,0,1,0,1,0,0,2,0,0,0,0,0,0,0
Medio_bajo,No_siniestro,620982,93,8707.76,50027.84,0,0,0,0,0,0,0,0,0,0,0,0,0,0
Medio_bajo,No_siniestro,621229,16,2418.61,0,0,0,0,0,0,0,0,0,0,0,0,0,0,0
Medio_bajo,No_siniestro,621398,51,346.33,0,0,0,0,0,0,0,0,0,0,0,0,0,0,0
Medio_bajo,No_siniestro,622083,9,2032.27,0,0,0,0,0,0,0,0,0,0,0,0,0,0,0
Medio_bajo,No_siniestro,622378,27,1235.22,0,0,0,0,0,0,0,0,0,0,0,0,0,0,0
Medio_bajo,No_siniestro,622722,14,5234.35,37053.22,0,0,0,0,0,0,0,0,0,0,0,0,0,0
Medio_bajo,No_siniestro,623022,93,328.8,0,0,0,0,0,0,0,0,0,0,0,0,0,0,0
Medio_bajo,No_siniestro,623339,46,897.18,0,0,1,0,0,0,0,1,0,0,0,0,0,0,0
Medio_bajo,No_siniestro,623388,19,963.43,0,0,0,0,0,0,0,0,0,0,0,0,0,0,0
Medio_bajo,No_siniestro,623687,47,2402.16,0,0,0,0,0,0,0,0,0,0,0,0,0,0,0
Medio_bajo,No_siniestro,624070,40,0.12,0,0,0,0,0,0,0,0,0,0,0,0,0,0,0
Medio_bajo,No_siniestro,624085,14,2716.57,0,0,0,0,0,0,0,0,0,0,0,0,0,0,0
Medio_bajo,No_siniestro,624707,8,406.22,72980.44,0,0,0,0,0,0,0,0,0,0,0,0,0,0
Medio_bajo,No_siniestro,624786,34,3612.13,0,0,0,0,0,0,0,0,0,0,0,0,0,0,0
Medio_bajo,No_siniestro,625187,35,506.67,39324.61,0,0,0,0,0,0,0,0,0,0,0,0,0,0
Medio_bajo,No_siniestro,625560,40,4324.24,0,0,0,0,0,0,0,0,0,0,0,0,0,0,0
Medio_bajo,No_siniestro,625600,40,3309.32,92358.85,0,0,0,0,0,0,0,0,0,0,0,0,0,0
Medio_bajo,No_siniestro,625745,10,51.27,0,0,0,0,0,0,0,0,0,0,0,0,0,0,0
Medio_bajo,No_siniestro,625826,115,2079.73,0,0,0,0,0,0,0,0,0,0,0,0,0,0,0
Medio_bajo,No_siniestro,626025,27,1502.18,0,0,0,0,0,0,0,0,0,0,0,0,0,0,0
Medio_bajo,No_siniestro,626496,9,105.57,28133.55,0,0,0,0,0,0,0,0,0,0,0,0,0,0
Medio_bajo,No_siniestro,626528,68,6436.33,0,1,0,0,1,0,0,2,0,0,0,0,0,0,0
Medio_bajo,No_siniestro,627291,62,5856.89,0,0,0,0,0,0,0,0,0,0,0,0,0,0,0
Medio_bajo,No_siniestro,627648,65,7588.15,0,0,0,0,0,0,0,0,0,0,0,0,0,0,0
Medio_bajo,No_siniestro,628292,16,8473.03,0,0,0,0,0,0,0,0,0,0,0,0,0,0,0
Medio_bajo,No_siniestro,628574,42,1117.94,0,0,0,0,0,0,0,0,0,0,0,0,0,0,0
Medio_bajo,No_siniestro,628888,29,4424.6,0,0,0,0,0,0,0,0,0,0,0,0,0,0,0
Medio_bajo,No_siniestro,628937,37,146.35,0,0,0,0,0,0,0,0,0,0,0,0,0,0,0
Medio_bajo,No_siniestro,630092,96,20324.84,0,0,0,0,0,0,0,0,0,0,0,0,0,0,0
Medio_bajo,No_siniestro,630097,43,445.86,0,0,0,0,0,0,0,0,0,0,0,0,0,0,0
Medio_bajo,No_siniestro,631052,6,121.22,0,0,0,0,0,0,0,0,0,0,0,0,0,0,0
Medio_bajo,No_siniestro,631539,13,801.79,0,0,0,0,0,0,0,0,0,0,0,0,0,0,0
Medio_bajo,No_siniestro,632559,30,58.72,0,0,0,0,0,0,0,0,0,0,0,0,0,0,0
Medio_bajo,No_siniestro,633193,58,459.99,0,0,0,0,0,0,0,0,0,0,0,0,0,0,0
Medio_bajo,No_siniestro,633754,24,520.32,0,0,0,0,0,0,0,0,0,0,0,0,0,0,0
Medio_bajo,No_siniestro,633797,82,759.35,0,0,0,0,0,0,0,0,0,0,0,0,0,0,0
Medio_bajo,No_siniestro,633845,88,5798.41,0,0,0,0,0,0,0,0,0,0,0,0,0,0,0
Medio_bajo,No_siniestro,634566,24,3226.37,0,0,0,1,0,0,1,2,0,0,0,0,0,0,0
Medio_bajo,No_siniestro,635016,6,441.27,0,0,0,0,0,0,0,0,0,0,0,0,0,0,0
Medio_bajo,No_siniestro,636396,9,0.1,0,0,0,0,0,0,0,0,0,0,0,0,0,0,0
Medio_bajo,No_siniestro,636617,60,7605.22,34113.8,0,0,0,0,0,0,0,0,0,0,0,0,0,0
Medio_bajo,No_siniestro,636884,42,1385,0,0,0,0,0,0,0,0,0,0,0,0,0,0,0
Medio_bajo,No_siniestro,638425,39,53.49,0,0,0,0,0,0,0,0,0,0,0,0,0,0,0
Medio_bajo,No_siniestro,639392,7,1542.35,0,0,0,0,0,0,0,0,0,0,0,0,0,0,0
Medio_bajo,No_siniestro,639415,41,83.71,0,0,0,0,0,0,0,0,0,0,0,0,0,0,0
Medio_bajo,No_siniestro,642274,64,227.43,0,0,0,0,0,0,0,0,0,0,0,0,0,0,0
Medio_bajo,No_siniestro,642305,8,179.73,0,0,0,0,0,0,0,0,0,0,0,0,0,0,0
Medio_bajo,No_siniestro,642566,16,1771.44,0,0,0,0,0,0,0,0,0,0,0,0,0,0,0
Medio_bajo,No_siniestro,642952,28,168.81,0,0,0,0,0,0,0,0,0,0,0,0,0,0,0
Medio_bajo,No_siniestro,644039,9,4.8,0,0,0,0,0,0,0,0,0,0,0,0,0,0,0
Medio_bajo,No_siniestro,644432,48,24608.15,37209.66,0,0,0,0,0,0,0,0,0,0,0,0,0,0
Medio_bajo,No_siniestro,647706,71,609.29,0,0,0,0,0,0,0,0,0,0,0,0,0,0,0
Medio_bajo,No_siniestro,647723,100,2952.09,0,0,0,0,0,0,0,0,0,0,0,0,0,0,0
Medio_bajo,No_siniestro,648479,58,1569.34,0,0,0,0,0,0,0,0,0,0,0,0,0,0,0
Medio_bajo,No_siniestro,650361,43,2796.69,0,0,0,0,0,0,0,0,0,0,0,0,0,0,0
Medio_bajo,No_siniestro,650468,128,141.15,0,0,0,0,0,0,0,0,0,0,0,0,0,0,0
Medio_bajo,No_siniestro,650496,112,15.67,0,0,0,0,0,0,0,0,0,0,0,0,0,0,0
Medio_bajo,No_siniestro,650808,114,2277.1,0,0,0,0,0,0,0,0,0,0,0,0,0,0,0
Medio_bajo,No_siniestro,650941,28,8550.54,0,0,0,0,0,0,0,0,0,0,0,0,0,0,0
Medio_bajo,No_siniestro,651081,95,692.81,0,0,0,0,0,0,0,0,0,0,0,0,0,0,0
Medio_bajo,No_siniestro,652034,141,10193.95,0,0,0,0,0,0,0,0,0,0,0,0,0,0,0
Medio_bajo,No_siniestro,652079,100,2643.87,0,0,0,0,0,0,0,0,0,0,0,0,0,0,0
Medio_bajo,No_siniestro,652098,35,1073.21,0,0,0,0,0,0,0,0,0,0,0,0,0,0,0
Medio_bajo,No_siniestro,652147,168,584.58,0,0,0,0,0,0,0,0,0,0,0,0,0,0,0
Medio_bajo,Si_siniestro,653609,96,232.05,0,0,0,0,0,0,0,0,0,0,0,0,0,0,0
Medio_bajo,No_siniestro,654074,208,423.81,0,0,0,0,0,0,0,0,0,0,0,0,0,0,0
Medio_bajo,No_siniestro,654475,12,659.38,0,0,0,0,0,0,0,0,0,0,0,0,0,0,0
Medio_bajo,No_siniestro,654534,196,133.7,0,0,1,0,0,0,0,1,0,0,0,0,0,0,0
Medio_bajo,No_siniestro,654610,43,1367.71,0,0,0,0,0,0,0,0,0,0,0,0,0,0,0
Medio_bajo,No_siniestro,654615,61,4557.92,0,0,0,0,0,0,0,0,0,0,0,0,0,0,0
Medio_bajo,No_siniestro,654860,43,510.05,0,0,0,0,0,0,0,0,0,0,0,0,0,0,0
Medio_bajo,No_siniestro,655269,43,5275.43,0,0,0,0,0,0,0,0,0,0,0,0,0,0,0
Medio_bajo,No_siniestro,655638,138,16515.82,25257.96,1,1,0,0,0,0,2,0,0,0,0,0,0,0
Medio_bajo,No_siniestro,655903,90,8426.25,50834.72,0,0,0,0,0,0,0,0,0,0,0,0,0,0
Medio_bajo,No_siniestro,656028,233,27709.53,0,0,0,0,0,0,0,0,0,0,0,0,0,0,0
Medio_bajo,Si_siniestro,656218,40,6399.79,0,0,0,0,0,0,0,0,0,0,0,0,0,0,0
Medio_bajo,Si_siniestro,656456,223,0.07,0,1,1,1,0,0,0,3,0,0,0,0,0,0,0
Medio_bajo,No_siniestro,656531,8,141.47,0,0,0,0,0,0,0,0,0,0,0,0,0,0,0
Medio_bajo,No_siniestro,656565,8,619.97,0,0,0,0,0,0,0,0,0,0,0,0,0,0,0
Medio_bajo,No_siniestro,656898,27,844.52,0,0,0,0,0,0,0,0,0,0,0,0,0,0,0
Medio_bajo,No_siniestro,656951,8,35,0,0,0,0,0,0,0,0,0,0,0,0,0,0,0
Medio_bajo,No_siniestro,657009,94,4626.39,0,0,0,0,0,0,0,0,0,0,0,0,0,0,0
Medio_bajo,No_siniestro,657727,18,1471.55,0,0,0,0,0,0,0,0,0,0,0,0,0,0,0
Medio_bajo,No_siniestro,658532,35,1720.85,0,0,0,0,0,0,0,0,0,0,0,0,0,0,0
Medio_bajo,No_siniestro,658597,134,10579.11,0,0,0,0,0,0,0,0,0,0,0,0,0,0,0
Medio_bajo,No_siniestro,659659,12,5262.91,0,1,0,0,0,1,1,3,0,0,0,0,0,0,0
Medio_bajo,No_siniestro,659721,87,5918.57,0,0,0,0,0,0,0,0,0,0,0,0,0,0,0
Medio_bajo,No_siniestro,660222,45,60.09,0,0,0,0,0,0,0,0,0,0,0,0,0,0,0
Medio_bajo,No_siniestro,660894,12,1027.34,0,0,0,0,0,0,0,0,0,0,0,0,0,0,0
Medio_bajo,No_siniestro,661108,17,5947.3,0,0,0,0,0,0,0,0,0,0,0,0,0,0,0
Medio_bajo,No_siniestro,661203,66,1332.77,0,0,1,0,0,0,0,1,0,0,0,0,0,0,0
Medio_bajo,No_siniestro,661935,25,55487.02,0,0,0,0,0,0,0,0,0,0,0,0,0,0,0
Medio_bajo,No_siniestro,662069,33,12062.98,0,0,0,0,0,0,0,0,0,0,0,0,0,0,0
Medio_bajo,No_siniestro,662086,36,104.82,0,0,0,0,0,0,0,0,0,0,0,0,0,0,0
Medio_bajo,No_siniestro,662863,26,402.97,0,0,0,0,0,0,0,0,0,0,0,0,0,0,0
Medio_bajo,No_siniestro,663437,127,895.9,0,0,0,0,0,0,0,0,0,0,0,0,0,0,0
Medio_bajo,No_siniestro,663677,59,2309.27,0,0,0,0,0,0,0,0,0,0,0,0,0,0,0
Medio_bajo,No_siniestro,663767,76,837.69,0,0,0,0,0,0,0,0,0,0,0,0,0,0,0
Medio_bajo,No_siniestro,663983,6,1740.82,0,0,0,0,0,0,0,0,0,0,0,0,0,0,0
Medio_bajo,No_siniestro,664200,43,8.26,0,0,0,0,0,0,0,0,0,0,0,0,0,0,0
Medio_bajo,No_siniestro,664790,43,781.2,0,0,0,0,0,0,0,0,0,0,0,0,0,0,0
Medio_bajo,Si_siniestro,664852,121,12067.63,7955.61,1,1,0,1,0,0,3,0,0,0,0,0,0,0
Medio_bajo,No_siniestro,665031,96,1265.2,0,0,0,0,0,0,0,0,0,0,0,0,0,0,0
Medio_bajo,No_siniestro,665182,93,5180.63,0,0,0,0,0,0,0,0,0,0,0,0,0,0,0
Medio_bajo,No_siniestro,665363,8,450.21,0,0,0,0,0,0,0,0,0,0,0,0,0,0,0
Medio_bajo,No_siniestro,665932,31,188.75,0,0,0,0,0,0,0,0,0,0,0,0,0,0,0
Medio_bajo,No_siniestro,666020,43,24357.54,0,0,0,0,0,0,0,0,0,0,0,0,0,0,0
Medio_bajo,No_siniestro,666268,82,5054.15,0,0,0,0,0,0,0,0,0,0,0,0,0,0,0
Medio_bajo,No_siniestro,666910,43,1271.99,0,1,1,0,0,0,0,2,0,0,0,0,0,0,0
Medio_bajo,No_siniestro,667311,25,2100.68,0,2,0,0,0,0,0,2,0,0,0,0,0,0,0
Medio_bajo,No_siniestro,668361,68,195.4,0,0,0,0,0,0,0,0,0,0,0,0,0,0,0
Medio_bajo,No_siniestro,668772,174,168.85,0,0,0,0,0,0,0,0,0,0,0,0,0,0,0
Medio_bajo,No_siniestro,668885,88,4133.49,74993.63,0,0,0,0,0,0,0,0,0,0,0,0,0,0
Medio_bajo,No_siniestro,669182,13,1697.73,0,0,0,0,0,0,0,0,0,0,0,0,0,0,0
Medio_bajo,No_siniestro,669383,138,4053.75,0,0,0,0,0,0,0,0,0,0,0,0,0,0,0
Medio_bajo,No_siniestro,669387,9,1041.17,0,0,0,0,0,0,0,0,0,0,0,0,0,0,0
Medio_bajo,No_siniestro,669390,43,403.01,0,0,0,0,0,0,0,0,0,0,0,0,0,0,0
Medio_bajo,No_siniestro,669394,61,2184.51,0,0,0,0,0,0,0,0,0,0,0,0,0,0,0
Medio_bajo,No_siniestro,669772,26,6563.06,0,0,0,0,0,0,0,0,0,0,0,0,0,0,0
Medio_bajo,No_siniestro,669791,13,798.38,0,0,0,0,0,0,0,0,0,0,0,0,0,0,0
Medio_bajo,No_siniestro,670508,95,1285.52,88560.25,0,0,0,0,0,0,0,0,0,0,0,0,0,0
Medio_bajo,No_siniestro,671121,11,7918.29,0,0,0,0,0,0,0,0,0,0,0,0,0,0,0
Medio_bajo,No_siniestro,671462,194,1679.02,0,0,0,0,0,0,0,0,0,0,0,0,0,0,0
Medio_bajo,No_siniestro,672026,14,5317.96,0,0,0,0,0,0,0,0,0,0,0,0,0,0,0
Medio_bajo,No_siniestro,672973,29,249.11,0,0,0,0,0,0,0,0,0,0,0,0,0,0,0
Medio_bajo,No_siniestro,672974,117,189.22,0,0,0,0,0,0,0,0,0,0,0,0,0,0,0
Medio_bajo,No_siniestro,673236,27,173.45,35323.74,0,0,0,0,0,0,0,0,0,0,0,0,0,0
Medio_bajo,No_siniestro,674360,43,15978.24,0,0,0,0,0,0,0,0,0,0,0,0,0,0,0
Medio_bajo,No_siniestro,674374,89,3644.85,0,0,0,0,0,0,0,0,0,0,0,0,0,0,0
Medio_bajo,No_siniestro,674431,133,648.1,0,0,0,0,0,0,0,0,0,0,0,0,0,0,0
Medio_bajo,No_siniestro,674503,8,6583.47,0,0,0,0,1,0,0,1,0,0,0,0,0,0,0
Medio_bajo,No_siniestro,675051,7,1.67,0,0,0,0,0,0,0,0,0,0,0,0,0,0,0
Medio_bajo,No_siniestro,676126,10,0.11,0,0,0,0,0,0,0,0,0,0,0,0,0,0,0
Medio_bajo,No_siniestro,677348,6,2778.43,0,0,0,0,1,1,0,2,0,0,0,0,0,0,0
Medio_bajo,No_siniestro,677366,86,4204.13,42921.83,0,0,0,0,0,0,0,0,0,0,0,0,0,0
Medio_bajo,No_siniestro,680305,6,9208.72,0,0,7,7,7,7,7,35,0,0,0,0,0,0,0
Medio_bajo,No_siniestro,680938,12,287.31,0,0,0,0,0,0,1,1,0,0,0,0,0,0,0
Medio_bajo,No_siniestro,680939,43,0.01,0,0,0,0,0,0,0,0,0,0,0,0,0,0,0
Medio_bajo,No_siniestro,681077,43,1130.95,0,0,0,0,0,0,0,0,0,0,0,0,0,0,0
Medio_bajo,No_siniestro,681301,12,684.69,0,0,0,0,0,0,0,0,0,0,0,0,0,0,0
Medio_bajo,No_siniestro,681448,25,1000.57,0,0,0,0,0,0,0,0,0,0,0,0,0,0,0
Medio_bajo,No_siniestro,681879,7,7211.37,0,0,0,0,0,0,0,0,0,0,0,0,0,0,0
Medio_bajo,No_siniestro,682042,176,242.63,0,0,7,7,7,7,7,35,0,0,0,0,0,0,0
Medio_bajo,No_siniestro,683017,55,959.75,0,0,0,0,0,0,0,0,0,0,0,0,0,0,0
Medio_bajo,No_siniestro,683080,43,814.45,22588.45,0,0,0,0,0,0,0,0,0,0,0,0,0,0
Medio_bajo,No_siniestro,683759,18,82.81,0,0,0,0,0,0,0,0,0,0,0,0,0,0,0
Medio_bajo,No_siniestro,684252,71,2866.62,0,0,0,0,0,0,0,0,0,0,0,0,0,0,0
Medio_bajo,No_siniestro,684354,31,676.01,0,0,0,0,0,0,0,0,0,0,0,0,0,0,0
Medio_bajo,No_siniestro,684871,81,7167.22,0,0,0,0,0,0,0,0,0,0,0,0,0,0,0
Medio_bajo,No_siniestro,685053,33,15658.72,57190.55,0,0,0,0,0,0,0,0,0,0,0,0,0,0
Medio_bajo,No_siniestro,685313,6,164.94,0,0,0,0,0,0,0,0,0,0,0,0,0,0,0
Medio_bajo,No_siniestro,685858,7,1424.23,0,1,0,1,0,0,1,3,0,0,0,0,0,0,0
Medio_bajo,No_siniestro,685998,36,116.1,0,0,0,0,0,0,0,0,0,0,0,0,0,0,0
Medio_bajo,No_siniestro,686220,43,1521.63,0,0,0,0,0,0,0,0,0,0,0,0,0,0,0
Medio_bajo,No_siniestro,686308,84,9.8,0,0,0,0,0,0,0,0,0,0,0,0,0,0,0
Medio_bajo,No_siniestro,686482,97,2187.98,22040.4,0,0,0,0,0,0,0,0,0,0,0,0,0,0
Medio_bajo,No_siniestro,686977,25,16923.18,0,0,0,0,0,0,0,0,0,0,0,0,0,0,0
Medio_bajo,No_siniestro,687187,46,2803.04,0,0,0,0,0,0,0,0,0,0,0,0,0,0,0
Medio_bajo,No_siniestro,687329,90,10194.14,0,0,0,0,0,0,0,0,0,0,0,0,0,0,0
Medio_bajo,No_siniestro,687555,68,5558.38,57811.67,0,0,0,0,0,0,0,0,0,0,0,0,0,0
Medio_bajo,No_siniestro,687872,10,40.12,0,0,0,0,0,0,0,0,0,0,0,0,0,0,0
Medio_bajo,No_siniestro,688518,76,166.39,0,0,0,0,0,0,0,0,0,0,0,0,0,0,0
Medio_bajo,No_siniestro,688593,32,335.44,0,0,0,0,0,0,0,0,0,0,0,0,0,0,0
Medio_bajo,No_siniestro,688729,34,1508.74,0,0,0,0,0,0,0,0,0,0,0,0,0,0,0
Medio_bajo,No_siniestro,689742,54,26342.79,0,0,0,0,0,0,0,0,0,0,0,0,0,0,0
Medio_bajo,No_siniestro,689785,44,144.23,0,0,0,0,0,0,0,0,0,0,0,0,0,0,0
Medio_bajo,No_siniestro,690029,85,6362.53,0,0,0,0,0,0,0,0,0,0,0,0,0,0,0
Medio_bajo,No_siniestro,690712,79,184.5,0,0,0,0,0,0,0,0,0,0,0,0,0,0,0
Medio_bajo,No_siniestro,691030,43,17.02,0,0,0,0,0,0,0,0,0,0,0,0,0,0,0
Medio_bajo,No_siniestro,691343,35,7642.63,0,0,0,1,0,1,0,2,0,0,0,0,0,0,0
Medio_bajo,Si_siniestro,691611,29,8507.14,0,0,0,0,0,0,0,0,0,0,0,0,0,0,0
Medio_bajo,No_siniestro,691815,42,219.32,0,0,0,0,1,0,0,1,0,0,0,0,0,0,0
Medio_bajo,No_siniestro,692111,102,748.63,0,1,0,0,0,0,0,1,0,0,0,0,0,0,0
Medio_bajo,No_siniestro,692932,30,175.49,0,0,0,0,0,0,0,0,0,0,0,0,0,0,0
Medio_bajo,No_siniestro,693139,75,2375.06,0,0,0,0,0,0,0,0,0,0,0,0,0,0,0
Medio_bajo,No_siniestro,694105,60,1045.57,50623.02,0,0,0,0,0,0,0,0,0,0,0,0,0,0
Medio_bajo,No_siniestro,694132,6,23.96,0,0,0,0,0,0,0,0,0,0,0,0,0,0,0
Medio_bajo,No_siniestro,694153,45,240.53,0,0,0,0,0,0,0,0,0,0,0,0,0,0,0
Medio_bajo,No_siniestro,694892,60,290.28,0,0,0,0,0,0,0,0,0,0,0,0,0,0,0
Medio_bajo,No_siniestro,694995,53,100.95,0,0,0,0,1,0,0,1,0,0,0,0,0,0,0
Medio_bajo,No_siniestro,695589,50,45.92,0,0,0,0,0,0,0,0,0,0,0,0,0,0,0
Medio_bajo,No_siniestro,696740,43,435.98,0,0,0,0,0,0,0,0,0,0,0,0,0,0,0
Medio_bajo,No_siniestro,696837,14,12606.33,0,0,0,0,0,0,0,0,0,0,0,0,0,0,0
Medio_bajo,No_siniestro,697296,78,1502.55,0,0,0,0,0,0,0,0,0,0,0,0,0,0,0
Medio_bajo,No_siniestro,697324,36,2968.82,0,0,0,0,0,0,0,0,0,0,0,0,0,0,0
Medio_bajo,No_siniestro,697673,54,2434.1,0,0,0,0,0,0,0,0,0,0,0,0,0,0,0
Medio_bajo,No_siniestro,698047,59,95.13,0,0,0,0,0,0,0,0,0,0,0,0,0,0,0
Medio_bajo,No_siniestro,698267,11,7401.39,0,0,0,0,0,0,0,0,0,0,0,0,0,0,0
Medio_bajo,No_siniestro,698374,29,224.07,0,0,0,0,0,0,0,0,0,0,0,0,0,0,0
Medio_bajo,No_siniestro,698382,10,756.15,0,0,0,0,0,0,0,0,0,0,0,0,0,0,0
Medio_bajo,No_siniestro,698935,18,765.99,0,0,0,0,0,0,0,0,0,0,0,0,0,0,0
Medio_bajo,No_siniestro,699205,58,1897.99,29893.31,0,0,0,0,0,0,0,0,0,0,0,0,0,0
Medio_bajo,No_siniestro,699907,37,677.14,0,0,0,0,0,0,0,0,0,0,0,0,0,0,0
Medio_bajo,No_siniestro,699936,74,113.01,0,0,0,0,0,0,0,0,0,0,0,0,0,0,0
Medio_bajo,No_siniestro,700237,31,1349.92,0,0,0,0,0,0,0,0,0,0,0,0,0,0,0
Medio_bajo,No_siniestro,700316,56,299.34,0,0,0,0,0,0,0,0,0,0,0,0,0,0,0
Medio_bajo,No_siniestro,701261,108,0.2,0,0,0,0,0,0,0,0,0,0,0,0,0,0,0
Medio_bajo,No_siniestro,701577,19,7147.25,47709.15,0,0,0,0,0,0,0,0,0,0,0,0,0,0
Medio_bajo,No_siniestro,702065,11,15098.5,0,0,0,0,0,0,0,0,0,0,0,0,0,0,0
Medio_bajo,No_siniestro,702582,93,9133.32,0,0,0,0,0,0,0,0,0,0,0,0,0,0,0
Medio_bajo,No_siniestro,703681,11,906.67,0,0,0,0,0,0,0,0,0,0,0,0,0,0,0
Medio_bajo,No_siniestro,704431,25,2671.67,0,0,0,0,0,0,0,0,0,0,0,0,0,0,0
Medio_bajo,No_siniestro,704527,40,4993.2,0,0,0,0,0,0,0,0,0,0,0,0,0,0,0
Medio_bajo,No_siniestro,704551,10,7423.28,0,0,0,0,0,0,0,0,0,0,0,0,0,0,0
Medio_bajo,No_siniestro,704785,84,2642.32,0,0,0,0,0,0,0,0,0,0,0,0,0,0,0
Medio_bajo,No_siniestro,707490,43,5258.64,17559.54,0,0,0,0,0,0,0,0,0,0,0,0,0,0
Medio_bajo,No_siniestro,707782,98,4956.67,0,0,0,0,0,0,0,0,0,0,0,0,0,0,0
Medio_bajo,No_siniestro,716294,57,793.4,0,0,0,0,0,0,0,0,0,0,0,0,0,0,0
Medio_bajo,No_siniestro,718065,31,2399.64,0,0,0,0,0,0,0,0,0,0,0,0,0,0,0
Medio_bajo,No_siniestro,720455,133,1895.82,0,0,0,0,0,0,0,0,0,0,0,0,0,0,0
Medio_bajo,No_siniestro,720492,100,7623.81,0,0,0,0,0,0,0,0,0,0,0,0,0,0,0
Medio_bajo,No_siniestro,720555,121,922.6,0,0,0,0,0,0,0,0,0,0,0,0,0,0,0
Medio_bajo,No_siniestro,720660,43,659.03,0,0,0,0,0,0,0,0,0,0,0,0,0,0,0
Medio_bajo,No_siniestro,721189,128,16345.95,0,0,0,0,0,0,0,0,0,0,0,0,0,0,0
Medio_bajo,No_siniestro,721442,128,178.19,0,0,0,0,0,0,1,1,0,0,0,0,0,0,0
Medio_bajo,No_siniestro,722933,152,326.05,0,0,0,0,0,0,0,0,0,0,0,0,0,0,0
Medio_bajo,No_siniestro,723057,59,569.97,0,0,7,7,7,7,7,35,0,0,0,0,0,0,0
Medio_bajo,No_siniestro,723345,115,497.5,0,0,0,0,0,0,0,0,0,0,0,0,0,0,0
Medio_bajo,No_siniestro,723624,126,2720.59,0,0,0,0,0,0,0,0,0,0,0,0,0,0,0
Medio_bajo,No_siniestro,723763,121,722.73,0,0,0,0,1,0,1,2,0,0,0,0,0,0,0
Medio_bajo,No_siniestro,724152,176,452.64,0,0,0,0,0,0,0,0,0,0,0,0,0,0,0
Medio_bajo,No_siniestro,724165,61,4202.31,0,0,0,0,0,0,0,0,0,0,0,0,0,0,0
Medio_bajo,No_siniestro,724171,153,3287.56,15571.69,0,0,0,0,0,0,0,0,0,0,0,0,0,0
Medio_bajo,No_siniestro,724441,133,2150.3,0,0,0,0,0,0,0,0,0,0,0,0,0,0,0
Medio_bajo,No_siniestro,724687,11,6202.55,10925.33,0,0,0,0,0,0,0,0,0,0,0,0,0,0
Medio_bajo,No_siniestro,724724,53,9315.23,0,0,0,0,0,0,0,0,0,0,0,0,0,0,0
Medio_bajo,No_siniestro,724836,131,87.42,17592.68,0,0,0,0,0,0,0,0,0,0,0,0,0,0
Medio_bajo,No_siniestro,724987,82,2034.81,0,0,0,0,0,0,0,0,0,0,0,0,0,0,0
Medio_bajo,No_siniestro,725337,75,1140.78,0,0,0,0,0,0,0,0,0,0,0,0,0,0,0
Medio_bajo,No_siniestro,725627,60,1120.12,0,0,0,0,0,0,0,0,0,0,0,0,0,0,0
Medio_bajo,No_siniestro,726140,43,2518.33,0,0,0,0,0,0,0,0,0,0,0,0,0,0,0
Medio_bajo,No_siniestro,726424,9,9711.79,0,0,0,1,1,1,1,4,0,0,0,0,0,0,0
Medio_bajo,No_siniestro,726496,26,1139.94,0,0,0,0,0,0,0,0,0,0,0,0,0,0,0
Medio_bajo,No_siniestro,726580,43,1070.79,84941.93,1,0,1,0,0,1,3,0,0,0,0,0,0,0
Medio_bajo,No_siniestro,726805,37,28.29,0,0,0,0,0,0,0,0,0,0,0,0,0,0,0
Medio_bajo,No_siniestro,726913,65,1735.46,0,0,0,0,0,0,0,0,0,0,0,0,0,0,0
Medio_bajo,No_siniestro,727543,93,435.5,0,1,0,0,0,0,0,1,0,0,0,0,0,0,0
Medio_bajo,No_siniestro,727651,119,1544.43,0,0,0,0,0,0,0,0,0,0,0,0,0,0,0
Medio_bajo,No_siniestro,727874,47,278.38,0,0,0,0,0,0,0,0,0,0,0,0,0,0,0
Medio_bajo,No_siniestro,728276,73,1709.79,0,1,0,0,0,0,0,1,0,0,0,0,0,0,0
Medio_bajo,No_siniestro,728797,71,3970.97,0,0,0,0,0,0,0,0,0,0,0,0,0,0,0
Medio_bajo,No_siniestro,728889,28,2633.98,0,0,0,0,0,0,0,0,0,0,0,0,0,0,0
Medio_bajo,No_siniestro,728942,162,52.58,0,0,0,0,0,0,0,0,0,0,0,0,0,0,0
Medio_bajo,No_siniestro,728967,26,8691.13,0,0,0,0,0,0,0,0,0,0,0,0,0,0,0
Medio_bajo,No_siniestro,729165,168,1053.19,0,0,0,0,0,0,0,0,0,0,0,0,0,0,0
Medio_bajo,No_siniestro,729173,11,17463.12,0,0,0,0,0,0,0,0,0,0,0,0,0,0,0
Medio_bajo,No_siniestro,729231,11,2853.51,0,0,0,0,0,0,0,0,0,0,0,0,0,0,0
Medio_bajo,No_siniestro,729577,85,6111.31,0,0,0,0,0,0,0,0,0,0,0,0,0,0,0
Medio_bajo,No_siniestro,729717,77,546.86,0,0,0,0,0,0,0,0,0,0,0,0,0,0,0
Medio_bajo,No_siniestro,730615,73,5017.61,0,0,0,0,0,0,0,0,0,0,0,0,0,0,0
Medio_bajo,No_siniestro,731981,59,1092.08,0,0,0,0,0,0,0,0,0,0,0,0,0,0,0
Medio_bajo,No_siniestro,732023,135,155.6,0,0,0,0,0,0,0,0,0,0,0,0,0,0,0
Medio_bajo,Si_siniestro,732642,10,2381.32,0,0,0,0,0,0,0,0,0,0,0,0,0,0,0
Medio_bajo,No_siniestro,732659,12,12029.3,0,0,0,0,0,0,0,0,0,0,0,0,0,0,0
Medio_bajo,No_siniestro,732679,139,2071.17,0,0,0,0,0,0,0,0,0,0,0,0,0,0,0
Medio_bajo,No_siniestro,732970,43,2713.37,0,0,0,0,0,0,0,0,0,0,0,0,0,0,0
Medio_bajo,No_siniestro,733245,10,486.95,0,0,0,0,0,0,0,0,0,0,0,0,0,0,0
Medio_bajo,No_siniestro,733309,88,531.37,0,0,0,0,0,0,0,0,0,0,0,0,0,0,0
Medio_bajo,No_siniestro,733588,71,495.82,0,0,0,0,0,0,0,0,0,0,0,0,0,0,0
Medio_bajo,No_siniestro,733830,43,246.59,0,0,0,0,0,0,0,0,0,0,0,0,0,0,0
Medio_bajo,No_siniestro,734105,75,7070.46,79661.82,0,0,0,0,0,0,0,0,0,0,0,0,0,0
Medio_bajo,No_siniestro,734664,66,733.37,0,0,0,0,0,0,0,0,0,0,0,0,0,0,0
Medio_bajo,No_siniestro,734928,30,2280.95,0,0,0,0,0,0,0,0,0,0,0,0,0,0,0
Medio_bajo,No_siniestro,735110,43,3634.37,0,0,0,0,0,0,0,0,0,0,0,0,0,0,0
Medio_bajo,No_siniestro,735143,65,107.54,0,0,0,0,0,0,0,0,0,0,0,0,0,0,0
Medio_bajo,No_siniestro,735253,15,965.53,0,0,0,0,0,0,0,0,0,0,0,0,0,0,0
Medio_bajo,No_siniestro,735641,32,735.25,0,0,0,1,0,1,0,2,0,0,0,0,0,0,0
Medio_bajo,No_siniestro,736332,38,414.8,0,0,0,0,0,0,0,0,0,0,0,0,0,0,0
Medio_bajo,No_siniestro,736674,11,1828.31,0,0,0,0,0,0,0,0,0,0,0,0,0,0,0
Medio_bajo,No_siniestro,737069,33,3590.81,0,0,0,0,0,0,0,0,0,0,0,0,0,0,0
Medio_bajo,No_siniestro,737151,34,10401.42,0,0,0,0,0,0,0,0,0,0,0,0,0,0,0
Medio_bajo,No_siniestro,737178,28,3446.83,0,0,0,0,1,0,0,1,0,0,0,0,0,0,0
Medio_bajo,No_siniestro,737648,104,16413.32,0,0,0,0,0,0,0,0,0,0,0,0,0,0,0
Medio_bajo,No_siniestro,737670,43,243.76,75616.24,0,0,0,0,0,0,0,0,0,0,0,0,0,0
Medio_bajo,No_siniestro,737786,13,6714.55,0,0,0,0,0,0,0,0,0,0,0,0,0,0,0
Medio_bajo,No_siniestro,738235,16,10374.92,0,0,0,0,0,0,0,0,0,0,0,0,0,0,0
Medio_bajo,No_siniestro,738482,85,1535.87,0,0,0,0,0,0,0,0,0,0,0,0,0,0,0
Medio_bajo,No_siniestro,739621,35,1490.32,0,0,0,0,0,0,0,0,0,0,0,0,0,0,0
Medio_bajo,No_siniestro,740410,43,5966.72,59955.4,0,0,0,0,0,0,0,0,0,0,0,0,0,0
Medio_bajo,No_siniestro,740589,32,596.24,0,0,0,0,0,0,0,0,0,0,0,0,0,0,0
Medio_bajo,No_siniestro,741521,100,204.86,0,0,0,0,0,0,0,0,0,0,0,0,0,0,0
Medio_bajo,No_siniestro,742065,7,5936.97,66308.3,0,0,0,0,0,0,0,0,0,0,0,0,0,0
Medio_bajo,No_siniestro,742321,8,1.86,0,0,0,0,0,0,0,0,0,0,0,0,0,0,0
Medio_bajo,No_siniestro,743470,43,188.24,0,0,0,0,0,0,2,2,0,0,0,0,0,0,0
Medio_bajo,No_siniestro,743959,63,10850.41,0,0,0,0,0,0,0,0,0,0,0,0,0,0,0
Medio_bajo,No_siniestro,743984,33,6225.98,0,0,0,0,0,0,0,0,0,0,0,0,0,0,0
Medio_bajo,No_siniestro,744086,46,7316.19,0,0,0,0,0,0,0,0,0,0,0,0,0,0,0
Medio_bajo,No_siniestro,744451,97,117.85,0,0,0,0,0,0,0,0,0,0,0,0,0,0,0
Medio_bajo,No_siniestro,744645,38,0.01,0,0,0,0,0,0,0,0,0,0,0,0,0,0,0
Medio_bajo,No_siniestro,745067,10,202.78,0,0,0,0,0,0,0,0,0,0,0,0,0,0,0
Medio_bajo,No_siniestro,745083,75,1996.96,12491,0,0,0,0,0,0,0,0,0,0,0,0,0,0
Medio_bajo,No_siniestro,745109,10,14104.09,0,0,0,0,0,0,0,0,0,0,0,0,0,0,0
Medio_bajo,No_siniestro,745150,43,903.71,0,0,0,0,0,0,0,0,0,0,0,0,0,0,0
Medio_bajo,No_siniestro,745156,92,7578,0,0,0,0,0,0,0,0,0,0,0,0,0,0,0
Medio_bajo,No_siniestro,745285,119,3746.93,0,0,0,0,0,0,0,0,0,0,0,0,0,0,0
Medio_bajo,No_siniestro,745722,61,13054.63,0,0,0,0,0,0,0,0,0,0,0,0,0,0,0
Medio_bajo,No_siniestro,745777,34,215.93,0,0,0,0,0,0,0,0,0,0,0,0,0,0,0
Medio_bajo,No_siniestro,745840,43,3519.61,0,0,0,0,0,0,0,0,0,0,0,0,0,0,0
Medio_bajo,No_siniestro,745967,87,1872.97,0,0,0,0,0,0,0,0,0,0,0,0,0,0,0
Medio_bajo,No_siniestro,746488,153,2803.31,0,0,0,0,0,0,0,0,0,0,0,0,0,0,0
Medio_bajo,No_siniestro,747564,49,1302.2,0,0,0,0,0,0,0,0,0,0,0,0,0,0,0
Medio_bajo,No_siniestro,747697,71,1825.27,0,0,0,0,0,0,0,0,0,0,0,0,0,0,0
Medio_bajo,No_siniestro,748288,62,20162.33,0,0,0,0,0,0,0,0,0,0,0,0,0,0,0
Medio_bajo,No_siniestro,748400,43,121.57,0,0,0,0,0,0,0,0,0,0,0,0,0,0,0
Medio_bajo,No_siniestro,748525,20,1074.58,0,0,0,0,0,0,0,0,0,0,0,0,0,0,0
Medio_bajo,No_siniestro,749144,18,32.92,0,0,0,0,0,0,0,0,0,0,0,0,0,0,0
Medio_bajo,No_siniestro,749755,85,23556.02,49993.87,0,0,0,0,0,0,0,0,0,0,0,0,0,0
Medio_bajo,No_siniestro,750312,10,1374.23,0,0,0,0,0,0,0,0,0,0,0,0,0,0,0
Medio_bajo,No_siniestro,750361,53,7571.33,0,0,0,0,0,0,0,0,0,0,0,0,0,0,0
Medio_bajo,No_siniestro,750427,14,328,0,0,0,0,0,0,0,0,0,0,0,0,0,0,0
Medio_bajo,No_siniestro,750430,43,6778.07,0,0,0,0,0,0,0,0,0,0,0,0,0,0,0
Medio_bajo,No_siniestro,750830,43,1080.48,0,0,0,0,0,0,0,0,0,0,0,0,0,0,0
Medio_bajo,No_siniestro,750945,66,16434.36,47400.17,0,0,0,0,0,0,0,0,0,0,0,0,0,0
Medio_bajo,Si_siniestro,751071,10,0.4,0,1,1,0,0,0,0,2,0,0,0,0,0,0,0
Medio_bajo,No_siniestro,751567,72,1971.08,0,0,0,0,0,0,0,0,0,0,0,0,0,0,0
Medio_bajo,No_siniestro,752250,43,21665.49,0,0,0,0,0,0,0,0,0,0,0,0,0,0,0
Medio_bajo,No_siniestro,752468,55,2632.03,0,0,0,0,0,0,0,0,0,0,0,0,0,0,0
Medio_bajo,No_siniestro,752693,56,368.65,0,0,0,0,0,0,0,0,0,0,0,0,0,0,0
Medio_bajo,No_siniestro,752897,38,1606.62,0,0,0,0,0,0,0,0,0,0,0,0,0,0,0
Medio_bajo,No_siniestro,753650,43,368.75,0,0,0,0,0,0,0,0,0,0,0,0,0,0,0
Medio_bajo,No_siniestro,753844,7,1626.87,0,0,0,0,0,0,0,0,0,0,0,0,0,0,0
Medio_bajo,No_siniestro,753886,25,1453.18,0,0,0,0,0,0,0,0,0,0,0,0,0,0,0
Medio_bajo,No_siniestro,754057,17,17477.13,0,0,0,0,0,1,1,2,0,0,0,0,0,0,0
Medio_bajo,No_siniestro,754408,82,22018.82,45626.49,0,0,0,0,0,0,0,0,0,0,0,0,0,0
Medio_bajo,No_siniestro,754471,16,14667.44,0,0,0,0,0,0,0,0,0,0,0,0,0,0,0
Medio_bajo,No_siniestro,754927,9,3182.59,0,0,0,0,0,0,0,0,0,0,0,0,0,0,0
Medio_bajo,No_siniestro,755488,32,350.7,0,0,0,0,0,0,0,0,0,0,0,0,0,0,0
Medio_bajo,No_siniestro,756083,32,216.35,0,0,0,0,0,0,0,0,0,0,0,0,0,0,0
Medio_bajo,No_siniestro,756265,13,7334.41,0,0,0,0,0,0,0,0,0,0,0,0,0,0,0
Medio_bajo,No_siniestro,757216,10,540.95,0,1,0,0,0,0,0,1,0,0,0,0,0,0,0
Medio_bajo,No_siniestro,757545,94,1972.34,0,0,0,0,0,0,0,0,0,0,0,0,0,0,0
Medio_bajo,No_siniestro,757845,94,1166.61,0,0,0,0,0,0,0,0,0,0,0,0,0,0,0
Medio_bajo,No_siniestro,757909,51,260.45,0,0,0,0,0,0,0,0,0,0,0,0,0,0,0
Medio_bajo,No_siniestro,757974,97,740.19,0,0,1,0,0,0,0,1,0,0,0,0,0,0,0
Medio_bajo,No_siniestro,758072,6,8207.46,0,0,0,0,0,0,0,0,0,0,0,0,0,0,0
Medio_bajo,No_siniestro,758725,84,11712.91,0,0,0,0,0,0,0,0,0,0,0,0,0,0,0
Medio_bajo,No_siniestro,759529,35,4441.84,0,0,0,0,0,0,0,0,0,0,0,0,0,0,0
Medio_bajo,No_siniestro,759748,72,1508.83,0,0,0,0,0,0,0,0,0,0,0,0,0,0,0
Medio_bajo,No_siniestro,760916,110,737.23,0,0,0,0,0,0,0,0,0,0,0,0,0,0,0
Medio_bajo,No_siniestro,761387,42,521.61,0,0,0,0,0,0,0,0,0,0,0,0,0,0,0
Medio_bajo,No_siniestro,762184,33,3826.59,0,0,0,0,0,0,0,0,0,0,0,0,0,0,0
Medio_bajo,No_siniestro,762356,11,7414.26,0,0,0,0,0,0,0,0,0,0,0,0,0,0,0
Medio_bajo,No_siniestro,762731,10,3538.32,0,0,0,0,0,0,0,0,0,0,0,0,0,0,0
Medio_bajo,No_siniestro,763223,95,5.28,28666.01,0,0,0,0,0,0,0,0,0,0,0,0,0,0
Medio_bajo,No_siniestro,763862,86,541.46,0,0,0,0,0,0,0,0,0,0,0,0,0,0,0
Medio_bajo,No_siniestro,764006,99,579.32,0,0,0,0,0,0,0,0,0,0,0,0,0,0,0
Medio_bajo,No_siniestro,764343,54,47.67,11157.75,0,0,0,0,0,0,0,0,0,0,0,0,0,0
Medio_bajo,No_siniestro,764935,12,360.32,53753.58,0,0,0,0,0,0,0,0,0,0,0,0,0,0
Medio_bajo,No_siniestro,765139,34,14.07,0,0,0,0,0,0,0,0,0,0,0,0,0,0,0
Medio_bajo,No_siniestro,765539,7,87.53,0,0,0,0,0,0,0,0,0,0,0,0,0,0,0
Medio_bajo,Si_siniestro,766056,11,4877.1,0,0,1,0,0,0,1,2,0,0,0,0,0,0,0
Medio_bajo,No_siniestro,766870,43,3.17,0,0,0,0,0,0,0,0,0,0,0,0,0,0,0
Medio_bajo,No_siniestro,767674,10,701.44,0,0,0,0,0,0,0,0,0,0,0,0,0,0,0
Medio_bajo,Si_siniestro,767823,7,2700.19,0,0,0,0,0,0,0,0,0,0,0,0,0,0,0
Medio_bajo,No_siniestro,767967,94,79.41,0,0,0,0,0,0,0,0,0,0,0,0,0,0,0
Medio_bajo,No_siniestro,768509,8,809.4,52171.38,0,0,0,0,0,0,0,0,0,0,0,0,0,0
Medio_bajo,No_siniestro,769787,93,281.69,0,0,1,0,0,0,0,1,0,0,0,0,0,0,0
Medio_bajo,No_siniestro,769916,38,1538.26,0,0,0,0,0,0,0,0,0,0,0,0,0,0,0
Medio_bajo,No_siniestro,770077,11,134.69,0,0,0,0,0,0,0,0,0,0,0,0,0,0,0
Medio_bajo,No_siniestro,770768,57,559.61,0,0,0,0,0,0,0,0,0,0,0,0,0,0,0
Medio_bajo,No_siniestro,771097,32,500.29,0,0,0,0,0,0,0,0,0,0,0,0,0,0,0
Medio_bajo,No_siniestro,771211,72,932.02,0,0,0,0,0,0,0,0,0,0,0,0,0,0,0
Medio_bajo,No_siniestro,771671,6,21.08,0,0,0,0,0,0,0,0,0,0,0,0,0,0,0
Medio_bajo,No_siniestro,771723,10,5907.32,0,0,0,0,0,0,0,0,0,0,0,0,0,0,0
Medio_bajo,No_siniestro,772093,54,226.59,0,0,0,0,0,0,0,0,0,0,0,0,0,0,0
Medio_bajo,No_siniestro,772375,18,4077.16,0,1,0,0,0,0,0,1,0,0,0,0,0,0,0
Medio_bajo,No_siniestro,773186,52,305.94,0,0,0,0,0,0,0,0,0,0,0,0,0,0,0
Medio_bajo,No_siniestro,773514,14,504.21,0,0,0,0,0,0,0,0,0,0,0,0,0,0,0
Medio_bajo,No_siniestro,773547,60,2289.17,0,0,0,0,0,0,0,0,0,0,0,0,0,0,0
Medio_bajo,No_siniestro,776118,20,232.13,0,0,0,0,0,0,0,0,0,0,0,0,0,0,0
Medio_bajo,No_siniestro,776380,43,175.11,0,0,0,0,0,0,0,0,0,0,0,0,0,0,0
Medio_bajo,No_siniestro,777124,24,451.79,0,0,0,0,0,0,0,0,0,0,0,0,0,0,0
Medio_bajo,No_siniestro,777288,48,7956.89,56569.53,0,0,0,0,0,0,0,0,0,0,0,0,0,0
Medio_bajo,No_siniestro,779602,9,5493.5,0,0,0,0,0,0,0,0,0,0,0,0,0,0,0
Medio_bajo,No_siniestro,782136,35,3409.72,0,0,0,0,0,0,0,0,0,0,0,0,0,0,0
Medio_bajo,No_siniestro,782975,7,13844.42,0,0,0,0,0,0,0,0,0,0,0,0,0,0,0
Medio_bajo,No_siniestro,783888,13,860.18,0,0,0,0,0,0,0,0,0,0,0,0,0,0,0
Medio_bajo,No_siniestro,783898,20,2611.21,0,0,0,0,0,0,0,0,0,0,0,0,0,0,0
Medio_bajo,Si_siniestro,784289,17,659.6,0,0,0,0,1,1,0,2,0,0,0,0,0,0,0
Medio_bajo,No_siniestro,785123,12,8541.4,0,0,0,0,0,0,0,0,0,0,0,0,0,0,0
Medio_bajo,No_siniestro,786599,9,932.38,0,0,0,0,0,0,0,0,0,0,0,0,0,0,0
Medio_bajo,No_siniestro,786758,9,778.06,0,0,0,0,0,0,0,0,0,0,0,0,0,0,0
Medio_bajo,No_siniestro,787883,19,8887.47,0,0,0,0,0,0,0,0,0,0,0,0,0,0,0
Medio_bajo,No_siniestro,787893,19,19021.67,0,1,1,1,0,1,0,4,0,0,0,0,0,0,0
Medio_bajo,No_siniestro,788980,43,1500.74,0,0,0,0,0,0,0,0,0,0,0,0,0,0,0
Medio_bajo,No_siniestro,789320,43,739.67,0,0,0,0,0,0,0,0,0,0,0,0,0,0,0
Medio_bajo,No_siniestro,1119,18,347.32,0,0,0,0,0,0,0,0,0,0,0,0,0,0,0
Medio_bajo,No_siniestro,3427,5,2063.25,0,0,0,0,0,0,0,0,0,0,0,0,0,0,0
Medio_bajo,No_siniestro,9514,175,0,0,0,0,0,0,0,0,0,0,0,0,0,0,0,0
Medio_bajo,No_siniestro,19891,25,0,0,0,0,0,0,0,0,0,0,0,0,0,0,0,0
Medio_bajo,No_siniestro,21971,75,1039.99,0,0,0,0,0,0,1,1,0,0,0,0,0,0,0
Medio_bajo,No_siniestro,23863,26,10483.78,0,0,0,0,0,0,0,0,0,0,0,0,0,0,0
Medio_bajo,No_siniestro,24001,108,0,0,0,0,0,1,0,1,2,0,0,0,0,0,0,0
Medio_bajo,No_siniestro,24262,190,0,0,0,0,0,0,0,0,0,0,0,0,0,0,0,0
Medio_bajo,No_siniestro,30127,74,1397.52,0,1,1,1,0,0,0,3,0,0,0,0,0,0,0
Medio_bajo,No_siniestro,32003,57,0,0,0,0,0,0,0,0,0,0,0,0,0,0,0,0
Medio_bajo,No_siniestro,41078,9,0,0,0,0,0,0,0,0,0,0,0,0,0,0,0,0
Medio_bajo,No_siniestro,42162,71,0,0,0,0,0,0,0,0,0,0,0,0,0,0,0,0
Medio_bajo,No_siniestro,45567,54,3090.04,0,0,0,1,0,0,1,2,0,0,0,0,0,0,0
Medio_bajo,No_siniestro,47945,0,1077.61,0,0,0,0,0,0,0,0,0,0,0,0,0,0,0
Medio_bajo,No_siniestro,49981,21,0,0,1,0,1,0,0,0,2,0,0,0,0,0,0,0
Medio_bajo,No_siniestro,51887,3,136.95,0,0,0,0,0,0,0,0,0,0,0,0,0,0,0
Medio_bajo,No_siniestro,62154,133,0,0,0,0,0,0,0,0,0,0,0,0,0,0,0,0
Medio_bajo,No_siniestro,62289,215,0,0,0,0,0,0,0,0,0,0,0,0,0,0,0,0
Medio_bajo,No_siniestro,63496,72,0,0,0,0,0,0,0,0,0,0,0,0,0,0,0,0
Medio_bajo,No_siniestro,64937,63,62.13,0,0,0,0,0,0,0,0,0,0,0,0,0,0,0
Medio_bajo,No_siniestro,67222,16,408.71,0,0,0,0,0,0,0,0,0,0,0,0,0,0,0
Medio_bajo,No_siniestro,67831,4,2895.08,0,1,0,0,0,0,0,1,0,0,0,0,0,0,0
Medio_bajo,No_siniestro,71418,73,0,0,0,0,0,0,0,0,0,0,0,0,0,0,0,0
Medio_bajo,No_siniestro,71734,192,0,0,0,0,0,0,0,0,0,0,0,0,0,0,0,0
Medio_bajo,No_siniestro,71850,42,0,0,0,0,0,0,0,0,0,0,0,0,0,0,0,0
Medio_bajo,No_siniestro,73989,69,0,0,0,0,0,0,0,0,0,0,0,0,0,0,0,0
Medio_bajo,No_siniestro,74663,16,0,0,0,0,1,0,0,0,1,0,0,0,0,0,0,0
Medio_bajo,No_siniestro,75663,20,1802.66,0,0,0,0,0,0,0,0,0,0,0,0,0,0,0
Medio_bajo,No_siniestro,76172,16,0,0,0,0,0,0,0,0,0,0,0,0,0,0,0,0
Medio_bajo,No_siniestro,76330,42,11840.31,0,0,0,0,0,0,0,0,0,0,0,0,0,0,0
Medio_bajo,No_siniestro,81785,106,0,0,0,0,0,1,0,0,1,0,0,0,0,0,0,0
Medio_bajo,No_siniestro,87922,10,3397.48,0,0,0,0,0,0,0,0,0,0,0,0,0,0,0
Medio_bajo,No_siniestro,88067,44,0,0,0,0,0,0,0,0,0,0,0,0,0,0,0,0
Medio_bajo,No_siniestro,94144,0,1302.4,0,0,0,0,0,0,0,0,0,0,0,0,0,0,0
Medio_bajo,No_siniestro,101369,2,5143.62,0,0,0,0,0,0,0,0,0,0,0,0,0,0,0
Medio_bajo,No_siniestro,103673,4,908.32,0,0,0,0,0,0,0,0,0,0,0,0,0,0,0
Medio_bajo,No_siniestro,104057,32,0,0,0,0,0,0,0,0,0,0,0,0,0,0,0,0
Medio_bajo,No_siniestro,107903,65,0,0,0,0,0,0,0,0,0,0,0,0,0,0,0,0
Medio_bajo,No_siniestro,108966,82,534.88,0,0,0,0,0,0,0,0,0,0,0,0,0,0,0
Medio_bajo,No_siniestro,109731,3,2.71,0,4,0,2,0,0,0,6,0,0,0,0,0,0,0
Medio_bajo,No_siniestro,110166,4,545.2,0,0,0,0,0,0,0,0,0,0,0,0,0,0,0
Medio_bajo,No_siniestro,110585,17,0,0,0,0,0,1,0,0,1,0,0,0,0,0,0,0
Medio_bajo,No_siniestro,110605,1,0,0,0,0,0,0,0,0,0,0,0,0,0,0,0,0
Medio_bajo,No_siniestro,110642,44,0,43933.41,0,0,0,0,0,0,0,0,0,0,0,0,0,0
Medio_bajo,No_siniestro,113158,6,1348.7,27346.94,0,0,0,0,0,0,0,0,0,0,0,0,0,0
Medio_bajo,No_siniestro,114026,10,839.36,0,0,0,0,0,0,0,0,0,0,0,0,0,0,0
Medio_bajo,No_siniestro,124889,58,0,0,0,0,0,0,0,0,0,0,0,0,0,0,0,0
Medio_bajo,No_siniestro,125155,42,0,0,0,0,0,0,0,0,0,0,0,0,0,0,0,0
Medio_bajo,No_siniestro,128306,73,0,0,0,0,0,0,0,0,0,0,0,0,0,0,0,0
Medio_bajo,No_siniestro,128962,143,4111.46,0,0,0,0,0,0,0,0,0,0,0,0,0,0,0
Medio_bajo,No_siniestro,129610,42,0,0,0,0,0,0,0,0,0,0,0,0,0,0,0,0
Medio_bajo,No_siniestro,130879,19,352.2,0,0,0,0,0,0,0,0,0,0,0,0,0,0,0
Medio_bajo,No_siniestro,133266,2,16847.19,0,0,0,0,0,0,0,0,0,0,0,0,0,0,0
Medio_bajo,No_siniestro,134860,42,5654.49,0,0,0,0,0,0,0,0,0,0,0,0,0,0,0
Medio_bajo,No_siniestro,138675,56,0,0,0,0,0,0,0,0,0,0,0,0,0,0,0,0
Medio_bajo,No_siniestro,138907,94,0,0,0,0,0,0,0,0,0,0,0,0,0,0,0,0
Medio_bajo,No_siniestro,139476,74,0,0,0,0,0,0,0,0,0,0,0,0,0,0,0,0
Medio_bajo,No_siniestro,140851,93,0,0,0,0,0,0,0,0,0,0,0,0,0,0,0,0
Medio_bajo,No_siniestro,143209,155,2093.39,0,0,0,0,0,0,0,0,0,0,0,0,0,0,0
Medio_bajo,No_siniestro,147574,2,302.25,0,0,7,0,0,0,0,7,0,0,0,0,0,0,0
Medio_bajo,No_siniestro,149685,1,0,0,0,0,0,0,0,0,0,0,0,0,0,0,0,0
Medio_bajo,No_siniestro,152008,73,0,0,0,0,0,0,0,0,0,0,0,0,0,0,0,0
Medio_bajo,No_siniestro,157838,156,577.27,17104.89,0,0,0,0,0,0,0,0,0,0,0,0,0,0
Medio_bajo,No_siniestro,160040,42,0,0,0,0,0,0,0,0,0,0,0,0,0,0,0,0
Medio_bajo,No_siniestro,160587,53,0,0,0,0,0,0,0,0,0,0,0,0,0,0,0,0
Medio_bajo,No_siniestro,160827,3,217.66,45239.87,0,0,0,0,0,0,0,0,0,0,0,0,0,0
Medio_bajo,No_siniestro,162395,90,0,0,0,0,0,0,0,0,0,0,0,0,0,0,0,0
Medio_bajo,No_siniestro,170800,42,0,0,0,0,0,0,0,0,0,0,0,0,0,0,0,0
Medio_bajo,No_siniestro,177559,0,226.63,0,0,0,0,0,0,0,0,0,0,0,0,0,0,0
Medio_bajo,No_siniestro,177623,3,345.93,0,0,0,0,0,0,0,0,0,0,0,0,0,0,0
Medio_bajo,No_siniestro,181365,39,0,0,0,0,0,0,0,0,0,0,0,0,0,0,0,0
Medio_bajo,No_siniestro,188219,0,81.15,0,0,0,0,0,0,0,0,0,0,0,0,0,0,0
Medio_bajo,No_siniestro,191603,16,866.24,0,0,0,0,0,0,0,0,0,0,0,0,0,0,0
Medio_bajo,No_siniestro,191611,6,1242.74,0,0,0,0,0,0,0,0,0,0,0,0,0,0,0
Medio_bajo,No_siniestro,193471,3,1577.79,0,0,0,0,0,0,0,0,0,0,0,0,0,0,0
Medio_bajo,No_siniestro,193811,3,11999.59,0,0,0,0,0,0,0,0,0,0,0,0,0,0,0
Medio_bajo,No_siniestro,194067,1,1308.45,0,0,0,0,0,0,0,0,0,0,0,0,0,0,0
Medio_bajo,No_siniestro,194786,18,0,0,0,1,1,1,1,1,5,0,0,0,0,0,0,0
Medio_bajo,No_siniestro,195507,3,7.98,0,0,0,0,0,0,0,0,0,0,0,0,0,0,0
Medio_bajo,No_siniestro,195516,2,22.58,0,0,0,0,0,0,0,0,0,0,0,0,0,0,0
Medio_bajo,No_siniestro,195743,97,1514.86,0,0,0,0,0,0,0,0,0,0,0,0,0,0,0
Medio_bajo,No_siniestro,197106,9,161.01,0,0,0,0,0,0,0,0,0,0,0,0,0,0,0
Medio_bajo,No_siniestro,198985,33,0,0,0,0,0,0,0,1,1,0,0,0,0,0,0,0
Medio_bajo,No_siniestro,199245,29,1473.4,0,0,0,0,0,0,0,0,0,0,0,0,0,0,0
Medio_bajo,No_siniestro,200717,0,0,0,0,0,0,0,0,0,0,0,0,0,0,0,0,0
Medio_bajo,No_siniestro,200992,9,335.45,0,0,0,0,0,0,0,0,0,0,0,0,0,0,0
Medio_bajo,No_siniestro,209402,44,0,0,0,0,0,0,0,0,0,0,0,0,0,0,0,0
Medio_bajo,No_siniestro,212045,1,134.82,0,0,0,0,0,0,0,0,0,0,0,0,0,0,0
Medio_bajo,No_siniestro,212549,108,0,0,0,0,0,0,0,0,0,0,0,0,0,0,0,0
Medio_bajo,No_siniestro,217330,42,6848.67,0,0,0,0,0,0,0,0,0,0,0,0,0,0,0
Medio_bajo,No_siniestro,220157,0,20.65,0,0,0,0,0,0,0,0,0,0,0,0,0,0,0
Medio_bajo,No_siniestro,222623,26,0,0,0,0,0,0,0,0,0,0,0,0,0,0,0,0
Medio_bajo,No_siniestro,225954,1,15.53,0,0,0,0,0,0,0,0,0,0,0,0,0,0,0
Medio_bajo,No_siniestro,226219,14,2714.56,0,0,0,0,0,0,0,0,0,0,0,0,0,0,0
Medio_bajo,No_siniestro,226246,3,0,0,0,0,0,0,0,0,0,0,0,0,0,0,0,0
Medio_bajo,No_siniestro,232820,42,8652.12,0,0,0,0,0,0,0,0,0,0,0,0,0,0,0
Medio_bajo,No_siniestro,234345,7,0,0,0,0,0,0,0,0,0,0,0,0,0,0,0,0
Medio_bajo,No_siniestro,240448,2,0,0,0,0,0,0,0,0,0,0,0,0,0,0,0,0
Medio_bajo,No_siniestro,242735,11,1077.27,0,0,1,1,0,1,1,4,0,0,0,0,0,0,0
Medio_bajo,No_siniestro,253004,3,809.8,0,0,0,0,0,0,0,0,0,0,0,0,0,0,0
Medio_bajo,No_siniestro,253548,1,468.79,0,0,0,0,0,0,0,0,0,0,0,0,0,0,0
Medio_bajo,No_siniestro,256968,5,710.7,0,0,0,0,0,0,0,0,0,0,0,0,0,0,0
Medio_bajo,No_siniestro,259245,175,0.15,0,0,0,0,0,0,0,0,0,0,0,0,0,0,0
Medio_bajo,No_siniestro,261936,0,0,0,0,0,0,0,0,0,0,0,0,0,0,0,0,0
Medio_bajo,No_siniestro,262208,2,35.79,0,0,0,0,0,0,0,0,0,0,0,0,0,0,0
Medio_bajo,No_siniestro,262319,1,2444.57,0,0,0,0,0,0,0,0,0,0,0,0,0,0,0
Medio_bajo,No_siniestro,262690,42,1062.64,37357.89,0,0,0,0,0,0,0,0,0,0,0,0,0,0
Medio_bajo,No_siniestro,262783,80,0,0,0,0,0,0,0,0,0,0,0,0,0,0,0,0
Medio_bajo,No_siniestro,263488,19,0,0,0,0,0,0,0,0,0,0,0,0,0,0,0,0
Medio_bajo,No_siniestro,263495,99,0,0,0,0,0,0,0,0,0,0,0,0,0,0,0,0
Medio_bajo,No_siniestro,264397,49,4345.3,9157.84,0,0,0,0,0,0,0,0,0,0,0,0,0,0
Medio_bajo,No_siniestro,271489,2,52,0,0,0,0,0,0,0,0,0,0,0,0,0,0,0
Medio_bajo,No_siniestro,277869,25,0,0,0,0,0,0,0,0,0,0,0,0,0,0,0,0
Medio_bajo,No_siniestro,280471,1,3198.05,0,0,0,0,0,0,0,0,0,0,0,0,0,0,0
Medio_bajo,No_siniestro,280857,109,0,0,0,0,0,0,0,0,0,0,0,0,0,0,0,0
Medio_bajo,No_siniestro,280945,54,332.1,0,0,0,0,0,0,0,0,0,0,0,0,0,0,0
Medio_bajo,No_siniestro,289273,108,0,0,0,0,0,0,0,0,0,0,0,0,0,0,0,0
Medio_bajo,No_siniestro,290813,8,133.63,0,0,0,0,0,0,0,0,0,0,0,0,0,0,0
Medio_bajo,No_siniestro,298795,3,0,0,0,0,0,0,0,0,0,0,0,0,0,0,0,0
Medio_bajo,No_siniestro,302084,114,0,0,0,0,0,0,0,0,0,0,0,0,0,0,0,0
Medio_bajo,No_siniestro,302093,47,0,0,0,0,0,0,0,0,0,0,0,0,0,0,0,0
Medio_bajo,No_siniestro,302096,0,22.51,0,0,0,0,0,0,0,0,0,0,0,0,0,0,0
Medio_bajo,No_siniestro,302241,4,73.39,58702.45,0,0,0,0,0,0,0,0,0,0,0,0,0,0
Medio_bajo,No_siniestro,307801,4,7079.68,0,0,0,0,0,0,0,0,0,0,0,0,0,0,0
Medio_bajo,No_siniestro,307922,1,5498.89,0,0,0,0,0,0,0,0,0,0,0,0,0,0,0
Medio_bajo,No_siniestro,314513,26,0,51965.67,0,0,0,0,0,0,0,0,0,0,0,0,0,0
Medio_bajo,No_siniestro,317410,42,0,0,0,0,0,0,0,0,0,0,0,0,0,0,0,0
Medio_bajo,No_siniestro,323955,113,18.43,0,0,0,0,0,0,0,0,0,0,0,0,0,0,0
Medio_bajo,No_siniestro,325814,20,0,0,0,1,0,1,0,0,2,0,0,0,0,0,0,0
Medio_bajo,No_siniestro,331099,28,0,0,0,0,0,0,0,0,0,0,0,0,0,0,0,0
Medio_bajo,No_siniestro,333474,16,899.08,0,0,0,0,0,1,0,1,0,0,0,0,0,0,0
Medio_bajo,No_siniestro,337336,20,0,0,0,0,0,0,0,0,0,0,0,0,0,0,0,0
Medio_bajo,No_siniestro,338755,3,1428.66,0,0,0,0,0,0,0,0,0,0,0,0,0,0,0
Medio_bajo,No_siniestro,343429,89,0,0,0,0,0,0,0,0,0,0,0,0,0,0,0,0
Medio_bajo,No_siniestro,346201,0,6051.63,0,0,0,0,0,0,0,0,0,0,0,0,0,0,0
Medio_bajo,No_siniestro,346513,102,0,0,0,0,0,0,0,0,0,0,0,0,0,0,0,0
Medio_bajo,No_siniestro,346519,1,18887.29,0,0,0,0,0,0,0,0,0,0,0,0,0,0,0
Medio_bajo,No_siniestro,347484,5,1968.65,0,0,0,0,0,0,0,0,0,0,0,0,0,0,0
Medio_bajo,No_siniestro,352440,42,0,0,0,0,0,0,0,0,0,0,0,0,0,0,0,0
Medio_bajo,No_siniestro,354062,5,10413.51,0,0,0,0,0,0,0,0,0,0,0,0,0,0,0
Medio_bajo,No_siniestro,356314,32,0,0,0,0,0,0,0,0,0,0,0,0,0,0,0,0
Medio_bajo,No_siniestro,358068,52,14,0,0,0,0,0,0,0,0,0,0,0,0,0,0,0
Medio_bajo,No_siniestro,358133,37,1023.34,0,0,0,0,0,0,0,0,0,0,0,0,0,0,0
Medio_bajo,No_siniestro,358373,0,249.42,0,0,0,0,0,0,0,0,0,0,0,0,0,0,0
Medio_bajo,No_siniestro,359289,3,78.62,0,0,0,0,0,0,0,0,0,0,0,0,0,0,0
Medio_bajo,No_siniestro,361450,42,0,0,0,0,0,0,0,0,0,0,0,0,0,0,0,0
Medio_bajo,No_siniestro,361914,3,119.6,0,0,0,0,0,0,0,0,0,0,0,0,0,0,0
Medio_bajo,No_siniestro,365857,4,1050.63,0,0,0,0,0,0,0,0,0,0,0,0,0,0,0
Medio_bajo,No_siniestro,366145,1,620.26,0,0,0,0,0,0,0,0,0,0,0,0,0,0,0
Medio_bajo,No_siniestro,366206,3,525.8,0,0,0,0,0,0,0,0,0,0,0,0,0,0,0
Medio_bajo,No_siniestro,368440,42,185.69,0,0,0,0,0,0,0,0,0,0,0,0,0,0,0
Medio_bajo,No_siniestro,369172,30,0,0,0,0,0,0,0,0,0,0,0,0,0,0,0,0
Medio_bajo,No_siniestro,370082,2,2320.54,15092.99,0,0,0,0,0,0,0,0,0,0,0,0,0,0
Medio_bajo,No_siniestro,371364,1,383.86,0,0,0,0,0,0,0,0,0,0,0,0,0,0,0
Medio_bajo,No_siniestro,374746,0,0,0,0,0,0,0,0,0,0,0,0,0,0,0,0,0
Medio_bajo,No_siniestro,377028,3,164.92,0,0,0,0,0,0,0,0,0,0,0,0,0,0,0
Medio_bajo,No_siniestro,380219,5,1393.24,0,0,0,0,0,0,0,0,0,0,0,0,0,0,0
Medio_bajo,No_siniestro,383047,7,0,0,0,0,0,0,0,0,0,0,0,0,0,0,0,0
Medio_bajo,No_siniestro,391081,68,0,0,0,0,0,0,0,0,0,0,0,0,0,0,0,0
Medio_bajo,No_siniestro,391877,28,0,0,0,0,0,0,0,0,0,0,0,0,0,0,0,0
Medio_bajo,No_siniestro,394802,0,6482.67,0,0,0,0,0,0,0,0,0,0,0,0,0,0,0
Medio_bajo,No_siniestro,396507,0,4008.72,0,0,0,0,0,0,0,0,0,0,0,0,0,0,0
Medio_bajo,No_siniestro,401258,2,4130.18,0,0,0,0,0,0,0,0,0,0,0,0,0,0,0
Medio_bajo,No_siniestro,402186,28,2105.33,0,0,0,0,0,0,0,0,0,0,0,0,0,0,0
Medio_bajo,No_siniestro,403697,121,0,0,0,0,0,0,0,0,0,0,0,0,0,0,0,0
Medio_bajo,No_siniestro,408280,42,201,0,0,0,0,0,0,0,0,0,0,0,0,0,0,0
Medio_bajo,No_siniestro,408294,3,80.29,0,0,0,0,0,0,0,0,0,0,0,0,0,0,0
Medio_bajo,No_siniestro,409833,0,1847.68,0,0,0,0,0,0,0,0,0,0,0,0,0,0,0
Medio_bajo,No_siniestro,411521,1,27.86,96784.18,0,0,0,0,0,0,0,0,0,0,0,0,0,0
Medio_bajo,No_siniestro,420768,46,1057.72,0,0,0,0,0,0,0,0,0,0,0,0,0,0,0
Medio_bajo,No_siniestro,420787,8,1144.35,0,0,0,0,0,0,0,0,0,0,0,0,0,0,0
Medio_bajo,No_siniestro,424634,4,1227.84,0,0,0,0,0,0,0,0,0,0,0,0,0,0,0
Medio_bajo,No_siniestro,425691,3,0,0,0,0,0,0,0,0,0,0,0,0,0,0,0,0
Medio_bajo,No_siniestro,430408,54,0,0,0,0,0,0,0,0,0,0,0,0,0,0,0,0
Medio_bajo,No_siniestro,433076,2,0,0,0,0,0,0,0,0,0,0,0,0,0,0,0,0
Medio_bajo,No_siniestro,433108,6,0,0,0,0,0,0,0,0,0,0,0,0,0,0,0,0
Medio_bajo,No_siniestro,433784,8,152.06,0,0,0,0,0,0,0,0,0,0,0,0,0,0,0
Medio_bajo,No_siniestro,435152,21,0,0,0,0,0,0,0,0,0,0,0,0,0,0,0,0
Medio_bajo,No_siniestro,436404,70,731.1,0,0,0,0,0,0,0,0,0,0,0,0,0,0,0
Medio_bajo,No_siniestro,438126,16,0,0,0,0,0,0,0,0,0,0,0,0,0,0,0,0
Medio_bajo,No_siniestro,445617,5,1374.14,45206.81,0,0,0,0,0,0,0,0,0,0,0,0,0,0
Medio_bajo,No_siniestro,445665,4,127.68,0,0,0,0,0,0,0,0,0,0,0,0,0,0,0
Medio_bajo,No_siniestro,448011,0,0,0,0,0,0,0,0,0,0,0,0,0,0,0,0,0
Medio_bajo,No_siniestro,449496,169,0,0,0,0,0,0,0,0,0,0,0,0,0,0,0,0
Medio_bajo,No_siniestro,450769,6,403.38,0,0,0,0,0,0,0,0,0,0,0,0,0,0,0
Medio_bajo,No_siniestro,452057,40,0,0,0,0,0,0,0,0,0,0,0,0,0,0,0,0
Medio_bajo,No_siniestro,452784,15,923.34,0,0,0,0,0,0,0,0,0,0,0,0,0,0,0
Medio_bajo,No_siniestro,455412,130,0,0,0,0,0,0,0,0,0,0,0,0,0,0,0,0
Medio_bajo,No_siniestro,456113,1,0,0,0,0,0,0,0,0,0,0,0,0,0,0,0,0
Medio_bajo,No_siniestro,459089,22,0,0,0,0,0,0,0,0,0,0,0,0,0,0,0,0
Medio_bajo,No_siniestro,459197,22,0,0,0,0,0,0,0,0,0,0,0,0,0,0,0,0
Medio_bajo,No_siniestro,459307,87,0,0,0,0,0,0,0,0,0,0,0,0,0,0,0,0
Medio_bajo,No_siniestro,465378,7,0,0,0,0,0,0,0,0,0,0,0,0,0,0,0,0
Medio_bajo,No_siniestro,468197,4,1046.88,0,0,0,0,0,0,0,0,0,0,0,0,0,0,0
Medio_bajo,No_siniestro,472603,78,1096.27,0,0,0,0,0,0,0,0,0,0,0,0,0,0,0
Medio_bajo,No_siniestro,473099,22,0,0,0,0,0,0,0,0,0,0,0,0,0,0,0,0
Medio_bajo,No_siniestro,475769,17,0,0,0,0,1,0,0,0,1,0,0,0,0,0,0,0
Medio_bajo,No_siniestro,476919,7,0,0,0,0,0,0,0,0,0,0,0,0,0,0,0,0
Medio_bajo,No_siniestro,478412,51,0,0,0,0,0,0,0,0,0,0,0,0,0,0,0,0
Medio_bajo,No_siniestro,479413,5,9718.21,0,0,0,0,0,0,0,0,0,0,0,0,0,0,0
Medio_bajo,No_siniestro,483070,42,94.86,0,0,0,0,0,0,0,0,0,0,0,0,0,0,0
Medio_bajo,No_siniestro,488465,91,254.35,0,0,0,0,0,0,1,1,0,0,0,0,0,0,0
Medio_bajo,No_siniestro,488677,22,0,0,0,0,0,0,7,7,14,0,0,0,0,0,0,0
Medio_bajo,No_siniestro,492761,4,0,66424.27,0,0,0,0,0,0,0,0,0,0,0,0,0,0
Medio_bajo,No_siniestro,494423,1,638.35,59500.72,0,0,0,0,0,0,0,0,0,0,0,0,0,0
Medio_bajo,No_siniestro,495761,1,2259.13,0,0,0,0,0,0,0,0,0,0,0,0,0,0,0
Medio_bajo,No_siniestro,495816,58,66.63,26250.58,0,0,0,0,0,0,0,0,0,0,0,0,0,0
Medio_bajo,No_siniestro,497977,52,372.78,0,0,0,0,0,0,0,0,0,0,0,0,0,0,0
Medio_bajo,No_siniestro,498198,5,476.05,0,0,0,0,0,0,0,0,0,0,0,0,0,0,0
Medio_bajo,No_siniestro,498523,5,243.95,0,0,0,0,0,0,0,0,0,0,0,0,0,0,0
Medio_bajo,No_siniestro,499615,4,2.41,0,0,0,0,0,0,0,0,0,0,0,0,0,0,0
Medio_bajo,No_siniestro,500702,93,0,0,0,0,0,0,0,0,0,0,0,0,0,0,0,0
Medio_bajo,No_siniestro,501503,5,7083.71,0,0,0,0,0,0,0,0,0,0,0,0,0,0,0
Medio_bajo,No_siniestro,504605,5,0,0,0,0,0,0,0,0,0,0,0,0,0,0,0,0
Medio_bajo,No_siniestro,515447,4,2793.73,0,0,0,0,0,0,0,0,0,0,0,0,0,0,0
Medio_bajo,No_siniestro,517440,42,315.26,0,0,0,0,0,0,0,0,0,0,0,0,0,0,0
Medio_bajo,No_siniestro,520281,0,8001.28,0,0,0,0,0,0,0,0,0,0,0,0,0,0,0
Medio_bajo,No_siniestro,521198,4,13762.36,0,0,0,0,0,0,0,0,0,0,0,0,0,0,0
Medio_bajo,No_siniestro,522196,110,0,0,0,0,0,0,0,0,0,0,0,0,0,0,0,0
Medio_bajo,No_siniestro,524043,2,5162.47,0,0,0,0,0,0,0,0,0,0,0,0,0,0,0
Medio_bajo,No_siniestro,524300,42,0,0,0,0,0,0,0,0,0,0,0,0,0,0,0,0
Medio_bajo,No_siniestro,524438,100,0,0,0,0,0,0,0,0,0,0,0,0,0,0,0,0
Medio_bajo,No_siniestro,525364,23,0,0,0,0,0,0,0,0,0,0,0,0,0,0,0,0
Medio_bajo,No_siniestro,529073,2,0,0,0,0,0,0,0,0,0,0,0,0,0,0,0,0
Medio_bajo,No_siniestro,532329,18,0,0,0,0,0,0,0,0,0,0,0,0,0,0,0,0
Medio_bajo,No_siniestro,532492,110,0,0,0,0,0,0,0,0,0,0,0,0,0,0,0,0
Medio_bajo,No_siniestro,533685,78,3710.85,0,0,0,0,0,0,0,0,0,0,0,0,0,0,0
Medio_bajo,No_siniestro,535064,67,0,0,0,0,0,0,0,0,0,0,0,0,0,0,0,0
Medio_bajo,No_siniestro,536024,3,103.14,0,0,0,0,0,0,0,0,0,0,0,0,0,0,0
Medio_bajo,No_siniestro,537485,6,0,14430.66,0,0,0,0,0,0,0,0,0,0,0,0,0,0
Medio_bajo,No_siniestro,542453,3,5551.49,0,0,0,0,0,0,0,0,0,0,0,0,0,0,0
Medio_bajo,No_siniestro,542621,2,13539.06,0,0,0,0,0,0,0,0,0,0,0,0,0,0,0
Medio_bajo,No_siniestro,543468,46,0,50622.13,0,0,0,0,0,0,0,0,0,0,0,0,0,0
Medio_bajo,No_siniestro,544930,42,300.73,38891.1,0,0,0,0,0,0,0,0,0,0,0,0,0,0
Medio_bajo,No_siniestro,545596,69,7,0,0,0,0,0,0,0,0,0,0,0,0,0,0,0
Medio_bajo,No_siniestro,560307,1,34.15,0,0,0,0,0,0,0,0,0,0,0,0,0,0,0
Medio_bajo,No_siniestro,564005,16,0,0,0,0,0,0,0,0,0,0,0,0,0,0,0,0
Medio_bajo,No_siniestro,570378,1,22.89,0,0,0,0,0,0,0,0,0,0,0,0,0,0,0
Medio_bajo,No_siniestro,572560,42,5.78,0,0,0,0,0,0,0,0,0,0,0,0,0,0,0
Medio_bajo,No_siniestro,572619,3,0,0,0,0,0,0,0,0,0,0,0,0,0,0,0,0
Medio_bajo,No_siniestro,575823,5,1878.47,0,0,0,0,0,0,0,0,0,0,0,0,0,0,0
Medio_bajo,No_siniestro,578867,3,1073.49,0,0,0,0,0,0,0,0,0,0,0,0,0,0,0
Medio_bajo,No_siniestro,581202,1,2454.02,0,0,0,0,0,0,0,0,0,0,0,0,0,0,0
Medio_bajo,No_siniestro,581207,1,6657.26,0,0,0,0,0,0,0,0,0,0,0,0,0,0,0
Medio_bajo,No_siniestro,581674,3,4098.66,0,4,6,5,0,0,0,15,0,0,0,0,0,0,0
Medio_bajo,No_siniestro,582496,191,0,0,0,0,0,0,0,0,0,0,0,0,0,0,0,0
Medio_bajo,No_siniestro,582654,113,0,0,0,0,0,0,0,0,0,0,0,0,0,0,0,0
Medio_bajo,No_siniestro,582766,202,0,12966.89,0,0,0,0,0,0,0,0,0,0,0,0,0,0
Medio_bajo,No_siniestro,586475,24,0,0,0,0,0,0,0,0,0,0,0,0,0,0,0,0
Medio_bajo,No_siniestro,591082,44,0,0,0,0,0,0,0,0,0,0,0,0,0,0,0,0
Medio_bajo,No_siniestro,595027,5,917.35,0,0,0,0,0,0,0,0,0,0,0,0,0,0,0
Medio_bajo,No_siniestro,601165,10,97.5,0,0,0,0,0,0,0,0,0,0,0,0,0,0,0
Medio_bajo,No_siniestro,601767,3,222.68,0,0,0,0,0,0,0,0,0,0,0,0,0,0,0
Medio_bajo,No_siniestro,603210,42,0,0,0,0,0,0,0,0,0,0,0,0,0,0,0,0
Medio_bajo,No_siniestro,604029,90,0,0,0,0,0,0,0,0,0,0,0,0,0,0,0,0
Medio_bajo,No_siniestro,606029,2,2615.8,0,0,0,0,0,0,0,0,0,0,0,0,0,0,0
Medio_bajo,No_siniestro,608150,42,0,0,0,0,0,0,0,0,0,0,0,0,0,0,0,0
Medio_bajo,No_siniestro,613713,15,538.87,0,0,0,0,0,0,0,0,0,0,0,0,0,0,0
Medio_bajo,No_siniestro,615381,24,0,0,0,0,0,0,0,0,0,0,0,0,0,0,0,0
Medio_bajo,No_siniestro,615610,42,0,0,0,0,0,0,0,0,0,0,0,0,0,0,0,0
Medio_bajo,No_siniestro,618513,24,4177.44,0,0,2,1,0,0,0,3,0,0,0,0,0,0,0
Medio_bajo,No_siniestro,625717,1,535.19,0,0,0,0,0,0,0,0,0,0,0,0,0,0,0
Medio_bajo,No_siniestro,632921,7,0,0,0,0,0,0,0,0,0,0,0,0,0,0,0,0
Medio_bajo,No_siniestro,634089,108,4166.94,0,1,1,1,1,1,1,6,0,0,0,0,0,0,0
Medio_bajo,No_siniestro,639033,34,13865.35,0,1,0,0,0,1,0,2,0,0,0,0,0,0,0
Medio_bajo,No_siniestro,639730,42,0,0,0,0,0,0,0,0,0,0,0,0,0,0,0,0
Medio_bajo,No_siniestro,641322,2,0,0,0,0,0,0,0,0,0,0,0,0,0,0,0,0
Medio_bajo,No_siniestro,641499,42,0,0,0,0,0,0,0,0,0,0,0,0,0,0,0,0
Medio_bajo,No_siniestro,643642,7,467.81,0,0,0,0,0,0,0,0,0,0,0,0,0,0,0
Medio_bajo,No_siniestro,644454,45,0,0,0,0,0,0,0,0,0,0,0,0,0,0,0,0
Medio_bajo,No_siniestro,647352,5,132.77,0,0,0,0,0,0,0,0,0,0,0,0,0,0,0
Medio_bajo,No_siniestro,647430,42,1937.32,0,0,0,0,0,0,0,0,0,0,0,0,0,0,0
Medio_bajo,No_siniestro,653421,100,0,0,0,0,0,0,0,0,0,0,0,0,0,0,0,0
Medio_bajo,No_siniestro,653567,5,2279.23,0,0,0,0,0,0,0,0,0,0,0,0,0,0,0
Medio_bajo,No_siniestro,654379,0,0,0,0,0,0,0,0,0,0,0,0,0,0,0,0,0
Medio_bajo,No_siniestro,661565,1,0,0,0,0,0,0,0,0,0,0,0,0,0,0,0,0
Medio_bajo,No_siniestro,662153,44,0,0,0,0,0,0,0,0,0,0,0,0,0,0,0,0
Medio_bajo,No_siniestro,665764,2,996.76,0,0,0,0,0,0,0,0,0,0,0,0,0,0,0
Medio_bajo,No_siniestro,667482,1,0,0,0,0,0,0,0,0,0,0,0,0,0,0,0,0
Medio_bajo,No_siniestro,668664,104,0,0,0,0,0,0,0,0,0,0,0,0,0,0,0,0
Medio_bajo,No_siniestro,669749,1,155.34,0,0,0,0,0,0,0,0,0,0,0,0,0,0,0
Medio_bajo,No_siniestro,672039,161,0,0,0,0,0,0,0,0,0,0,0,0,0,0,0,0
Medio_bajo,No_siniestro,678314,65,0,44111.56,0,0,0,0,0,0,0,0,0,0,0,0,0,0
Medio_bajo,No_siniestro,679302,32,0,0,0,0,0,0,0,0,0,0,0,0,0,0,0,0
Medio_bajo,No_siniestro,681418,0,0,0,0,0,0,0,0,0,0,0,0,0,0,0,0,0
Medio_bajo,No_siniestro,683397,55,399.53,0,0,0,0,0,0,0,0,0,0,0,0,0,0,0
Medio_bajo,No_siniestro,686586,5,10179.99,0,0,0,0,0,0,0,0,0,0,0,0,0,0,0
Medio_bajo,No_siniestro,687658,3,0,0,0,0,0,0,0,0,0,0,0,0,0,0,0,0
Medio_bajo,No_siniestro,688552,75,0,0,0,0,0,0,0,0,0,0,0,0,0,0,0,0
Medio_bajo,No_siniestro,690514,90,0,0,0,0,0,0,0,0,0,0,0,0,0,0,0,0
Medio_bajo,No_siniestro,694858,1,0,0,0,0,0,0,0,0,0,0,0,0,0,0,0,0
Medio_bajo,No_siniestro,699549,3,274.93,0,0,0,0,0,0,0,0,0,0,0,0,0,0,0
Medio_bajo,No_siniestro,702617,95,0,0,0,0,0,0,0,0,0,0,0,0,0,0,0,0
Medio_bajo,No_siniestro,703062,0,0,0,0,0,0,0,0,0,0,0,0,0,0,0,0,0
Medio_bajo,No_siniestro,710438,34,0,0,2,1,0,0,0,0,3,0,0,0,0,0,0,0
Medio_bajo,No_siniestro,713724,0,3191.24,0,1,0,0,0,0,0,1,0,0,0,0,0,0,0
Medio_bajo,No_siniestro,715157,14,0,0,0,0,0,0,0,0,0,0,0,0,0,0,0,0
Medio_bajo,No_siniestro,721328,39,0,0,0,0,0,0,0,0,0,0,0,0,0,0,0,0
Medio_bajo,No_siniestro,722584,3,656.85,0,0,0,0,0,0,0,0,0,0,0,0,0,0,0
Medio_bajo,No_siniestro,722923,65,0,0,0,0,0,0,0,0,0,0,0,0,0,0,0,0
Medio_bajo,No_siniestro,723621,66,0,0,0,0,0,0,0,0,0,0,0,0,0,0,0,0
Medio_bajo,No_siniestro,724323,26,0,0,0,0,0,0,0,0,0,0,0,0,0,0,0,0
Medio_bajo,No_siniestro,725748,2,22239.7,0,0,0,0,0,0,0,0,0,0,0,0,0,0,0
Medio_bajo,No_siniestro,728023,2,553.27,0,0,0,0,0,0,0,0,0,0,0,0,0,0,0
Medio_bajo,No_siniestro,729304,5,0,0,0,0,0,0,0,0,0,0,0,0,0,0,0,0
Medio_bajo,No_siniestro,733422,13,0,8898.16,0,0,0,0,0,0,0,0,0,0,0,0,0,0
Medio_bajo,No_siniestro,733561,18,485.11,0,0,0,0,0,0,0,0,0,0,0,0,0,0,0
Medio_bajo,No_siniestro,735727,62,0,0,0,0,0,0,0,0,0,0,0,0,0,0,0,0
Medio_bajo,No_siniestro,740435,47,0,0,0,0,0,0,1,0,1,0,0,0,0,0,0,0
Medio_bajo,No_siniestro,740824,24,1548.83,0,0,0,0,0,1,0,1,0,0,0,0,0,0,0
Medio_bajo,No_siniestro,741993,0,0,0,0,0,0,0,0,0,0,0,0,0,0,0,0,0
Medio_bajo,No_siniestro,743907,1,0,0,0,0,0,0,0,0,0,0,0,0,0,0,0,0
Medio_bajo,No_siniestro,745533,13,0,0,0,0,0,0,0,0,0,0,0,0,0,0,0,0
Medio_bajo,No_siniestro,752377,5,620.85,38694.73,0,0,0,0,0,0,0,0,0,0,0,0,0,0
Medio_bajo,No_siniestro,753948,26,0,0,0,0,0,0,0,0,0,0,0,0,0,0,0,0
Medio_bajo,No_siniestro,755948,83,0,0,0,0,3,2,0,0,5,0,0,0,0,0,0,0
Medio_bajo,No_siniestro,761525,6,14547.51,0,0,0,0,0,0,0,0,0,0,0,0,0,0,0
Medio_bajo,No_siniestro,762952,2,598.13,19354.18,0,0,0,0,0,0,0,0,0,0,0,0,0,0
Medio_bajo,No_siniestro,766285,2,35.68,0,0,0,0,0,0,0,0,0,0,0,0,0,0,0
Medio_bajo,No_siniestro,767742,107,0,0,0,0,0,0,0,0,0,0,0,0,0,0,0,0
Medio_bajo,No_siniestro,771021,26,0,0,0,0,0,0,0,0,0,0,0,0,0,0,0,0
Medio_bajo,No_siniestro,781018,29,33.38,0,0,0,0,0,0,0,0,0,0,0,0,0,0,0
Medio_bajo,No_siniestro,790346,0,0.01,0,0,0,0,0,0,0,0,0,0,0,0,0,0,0
Medio_alto,No_siniestro,1717,220,12495.04,0,0,0,0,0,0,0,0,0,0,0,0,0,0,0
Medio_alto,No_siniestro,2174,85,3646.29,0,0,0,0,0,0,0,0,0,0,0,0,0,0,0
Medio_alto,No_siniestro,2647,51,6360.2,0,0,0,0,0,0,0,0,0,0,0,0,0,0,0
Medio_alto,No_siniestro,3781,72,15786.2,0,0,0,0,0,0,0,0,0,0,0,0,0,0,0
Medio_alto,No_siniestro,4460,39,21713.43,0,0,0,0,0,0,0,0,0,0,0,0,0,0,0
Medio_alto,No_siniestro,5439,44,5024.34,0,0,0,0,0,0,0,0,0,0,0,0,0,0,0
Medio_alto,No_siniestro,6226,95,392.96,18725.4,0,0,0,0,0,0,0,0,0,0,0,0,0,0
Medio_alto,No_siniestro,6350,39,10131.35,0,0,0,0,0,0,0,0,0,0,0,0,0,0,0
Medio_alto,No_siniestro,6407,168,1921.27,0,0,2,1,0,0,0,3,0,0,0,0,0,0,0
Medio_alto,No_siniestro,8249,45,694.06,0,0,0,0,1,1,0,2,0,0,0,0,0,0,0
Medio_alto,No_siniestro,9305,61,261.64,0,0,0,0,0,0,0,0,0,0,0,0,0,0,0
Medio_alto,No_siniestro,10249,201,22782.45,0,0,0,0,0,1,1,2,0,0,0,0,0,0,0
Medio_alto,No_siniestro,10527,75,15231.65,0,0,0,0,0,0,0,0,0,0,0,0,0,0,0
Medio_alto,No_siniestro,11668,35,5939.78,0,0,0,0,0,0,0,0,0,0,0,0,0,0,0
Medio_alto,No_siniestro,13183,180,16716.27,0,0,0,0,0,0,0,0,0,0,0,0,0,0,0
Medio_alto,No_siniestro,13197,52,190.73,77687.77,0,0,0,0,0,0,0,0,0,0,0,0,0,0
Medio_alto,No_siniestro,14055,59,2022.76,110346.89,0,0,0,0,0,0,0,0,0,0,0,0,0,0
Medio_alto,No_siniestro,14227,156,228.49,0,0,0,0,0,0,0,0,0,0,0,0,0,0,0
Medio_alto,No_siniestro,15027,85,602.53,0,0,0,0,0,0,0,0,0,0,0,0,0,0,0
Medio_alto,No_siniestro,15844,8,12719.2,0,0,0,0,0,0,0,0,0,0,0,0,0,0,0
Medio_alto,No_siniestro,16994,111,2502.43,32363.4,0,0,0,0,0,0,0,0,0,0,0,0,0,0
Medio_alto,No_siniestro,17468,164,16604.95,170887.7,0,0,0,0,1,1,2,0,0,0,0,0,0,0
Medio_alto,No_siniestro,18734,173,93.15,0,0,0,0,0,0,0,0,0,0,0,0,0,0,0
Medio_alto,No_siniestro,19347,134,8322.24,0,0,0,0,0,1,0,1,0,0,0,0,0,0,0
Medio_alto,No_siniestro,19387,121,20395.47,0,0,1,0,0,0,0,1,0,0,0,0,0,0,0
Medio_alto,No_siniestro,19665,89,8978.59,145709.67,0,0,0,0,0,0,0,0,0,0,0,0,0,0
Medio_alto,No_siniestro,19777,84,24992.56,42664.47,0,0,0,0,0,0,0,0,0,0,0,0,0,0
Medio_alto,No_siniestro,22221,22,3096.54,0,0,0,0,0,0,0,0,0,0,0,0,0,0,0
Medio_alto,No_siniestro,22672,121,20.29,0,0,0,0,0,0,0,0,0,0,0,0,0,0,0
Medio_alto,No_siniestro,25506,119,1820.14,133004.19,0,0,0,0,0,0,0,0,0,0,0,0,0,0
Medio_alto,No_siniestro,27633,60,57.9,0,0,0,0,0,0,0,0,0,0,0,0,0,0,0
Medio_alto,No_siniestro,31385,49,2046.33,0,0,0,0,0,0,0,0,0,0,0,0,0,0,0
Medio_alto,No_siniestro,36603,93,2398.96,0,0,0,0,0,0,0,0,0,0,0,0,0,0,0
Medio_alto,No_siniestro,36631,90,26129.67,76749,0,0,0,0,0,0,0,0,0,0,0,0,0,0
Medio_alto,No_siniestro,36968,21,2057.91,28039.65,0,0,0,0,0,0,0,0,0,0,0,0,0,0
Medio_alto,No_siniestro,37002,50,58.84,0,0,0,0,0,0,0,0,0,0,0,0,0,0,0
Medio_alto,No_siniestro,39835,18,3407.98,57076.78,0,0,0,0,0,0,0,0,0,0,0,0,0,0
Medio_alto,No_siniestro,41446,97,7144.64,0,0,0,0,0,0,0,0,0,0,0,0,0,0,0
Medio_alto,No_siniestro,41855,9,17321.83,0,0,0,0,0,0,0,0,0,0,0,0,0,0,0
Medio_alto,No_siniestro,42340,39,354.05,62569.78,0,0,0,0,0,0,0,0,0,0,0,0,0,0
Medio_alto,No_siniestro,43288,39,9310.99,0,0,0,0,0,0,0,0,0,0,0,0,0,0,0
Medio_alto,No_siniestro,62582,56,5488.85,0,0,0,0,0,0,0,0,0,0,0,0,0,0,0
Medio_alto,No_siniestro,63866,55,37.03,0,0,0,0,0,0,0,0,0,0,0,0,0,0,0
Medio_alto,No_siniestro,64357,140,148.25,1409.14,0,0,0,0,0,0,0,0,0,0,0,0,0,0
Medio_alto,No_siniestro,64437,52,215.66,0,0,0,0,0,0,0,0,0,0,0,0,0,0,0
Medio_alto,No_siniestro,64514,99,856.34,0,0,0,0,0,0,0,0,0,0,0,0,0,0,0
Medio_alto,No_siniestro,64579,123,17480.29,0,0,0,0,0,0,0,0,0,0,0,0,0,0,0
Medio_alto,No_siniestro,65063,26,12249.65,0,0,0,0,0,0,0,0,0,0,0,0,0,0,0
Medio_alto,No_siniestro,65413,23,23336.13,0,0,0,0,0,0,0,0,0,0,0,0,0,0,0
Medio_alto,No_siniestro,66896,58,5581.5,0,0,0,0,0,0,0,0,0,0,0,0,0,0,0
Medio_alto,No_siniestro,68309,95,4564.79,0,0,1,0,0,0,1,2,0,0,0,0,0,0,0
Medio_alto,No_siniestro,69722,64,9085.76,0,0,0,0,0,0,0,0,0,0,0,0,0,0,0
Medio_alto,No_siniestro,69955,128,296.27,0,0,0,0,0,0,0,0,0,0,0,0,0,0,0
Medio_alto,No_siniestro,71264,192,13176.44,0,0,0,0,0,0,0,0,0,0,0,0,0,0,0
Medio_alto,No_siniestro,71595,67,376.18,0,0,0,0,0,0,0,0,0,0,0,0,0,0,0
Medio_alto,No_siniestro,75273,155,692.04,0,0,0,0,0,0,0,0,0,0,0,0,0,0,0
Medio_alto,No_siniestro,75775,125,1282.85,1661.85,0,0,0,0,0,0,0,0,0,0,0,0,0,0
Medio_alto,No_siniestro,76502,74,6431.29,0,0,0,0,0,0,0,0,0,0,0,0,0,0,0
Medio_alto,No_siniestro,77551,140,975.86,0,0,0,0,0,0,0,0,0,0,0,0,0,0,0
Medio_alto,No_siniestro,77770,39,36242.97,0,0,0,0,0,0,0,0,0,0,0,0,0,0,0
Medio_alto,No_siniestro,78939,63,6972.21,0,0,0,0,0,0,0,0,0,0,0,0,0,0,0
Medio_alto,No_siniestro,79026,82,622.46,51976.33,0,0,0,0,0,0,0,0,0,0,0,0,0,0
Medio_alto,No_siniestro,82105,59,15646.71,0,0,0,0,1,0,0,1,0,0,0,0,0,0,0
Medio_alto,No_siniestro,82634,166,2916.7,0,0,1,0,1,0,0,2,0,0,0,0,0,0,0
Medio_alto,No_siniestro,82845,97,39440.96,0,0,0,1,0,0,1,2,0,0,0,0,0,0,0
Medio_alto,No_siniestro,84554,66,22994.21,0,0,0,0,0,0,0,0,0,0,0,0,0,0,0
Medio_alto,No_siniestro,84607,97,17096.33,0,0,0,0,0,0,0,0,0,0,0,0,0,0,0
Medio_alto,No_siniestro,86067,52,2299.59,16288.36,0,0,0,0,0,0,0,0,0,0,0,0,0,0
Medio_alto,No_siniestro,87544,30,153.61,0,0,0,0,0,0,0,0,0,0,0,0,0,0,0
Medio_alto,No_siniestro,89359,11,20620.11,16924.05,0,0,0,0,0,0,0,0,0,0,0,0,0,0
Medio_alto,No_siniestro,89750,39,105.11,0,0,0,0,0,0,0,0,0,0,0,0,0,0,0
Medio_alto,No_siniestro,89849,96,375.57,64779.21,0,0,0,0,0,0,0,0,0,0,0,0,0,0
Medio_alto,No_siniestro,90739,52,990.69,0,0,0,0,0,0,0,0,0,0,0,0,0,0,0
Medio_alto,No_siniestro,91491,90,24870.47,57522.48,0,0,0,0,1,1,2,0,0,0,0,0,0,0
Medio_alto,No_siniestro,91792,114,5554.9,0,0,1,1,0,0,0,2,0,0,0,0,0,0,0
Medio_alto,No_siniestro,92409,140,2754.92,52856.55,0,0,0,0,0,0,0,0,0,0,0,0,0,0
Medio_alto,No_siniestro,95227,51,1383.17,38007.42,0,0,0,0,0,0,0,0,0,0,0,0,0,0
Medio_alto,No_siniestro,95245,71,4968.97,0,0,0,0,0,0,0,0,0,0,0,0,0,0,0
Medio_alto,No_siniestro,96072,79,240.03,0,0,0,0,0,0,0,0,0,0,0,0,0,0,0
Medio_alto,No_siniestro,98062,77,713.35,0,0,0,0,0,0,0,0,0,0,0,0,0,0,0
Medio_alto,No_siniestro,103611,35,4195.28,81891.53,0,0,0,0,0,0,0,0,0,0,0,0,0,0
Medio_alto,No_siniestro,123642,62,2856.47,0,0,0,0,0,0,0,0,0,0,0,0,0,0,0
Medio_alto,No_siniestro,124784,71,2248.71,0,0,0,0,0,0,0,0,0,0,0,0,0,0,0
Medio_alto,No_siniestro,125385,161,950.25,0,0,0,0,0,0,0,0,0,0,0,0,0,0,0
Medio_alto,No_siniestro,125454,37,416.16,0,0,0,0,0,0,0,0,0,0,0,0,0,0,0
Medio_alto,No_siniestro,125539,99,6019.23,0,0,0,0,0,0,0,0,0,0,0,0,0,0,0
Medio_alto,No_siniestro,125588,106,6103.63,0,0,0,0,0,0,0,0,0,0,0,0,0,0,0
Medio_alto,Si_siniestro,128553,116,8641.02,0,0,0,0,0,0,0,0,0,0,0,0,0,0,0
Medio_alto,No_siniestro,131788,123,231.47,0,0,0,0,0,0,0,0,0,0,0,0,0,0,0
Medio_alto,No_siniestro,132048,189,2506.79,0,0,0,0,0,0,0,0,0,0,0,0,0,0,0
Medio_alto,No_siniestro,132072,184,157.48,0,0,0,0,0,0,0,0,0,0,0,0,0,0,0
Medio_alto,No_siniestro,132124,98,7073.87,0,0,0,0,0,0,0,0,0,0,0,0,0,0,0
Medio_alto,No_siniestro,132321,9,993.37,0,0,0,0,0,0,0,0,0,0,0,0,0,0,0
Medio_alto,No_siniestro,133021,150,49435.69,0,0,0,0,0,0,0,0,0,0,0,0,0,0,0
Medio_alto,No_siniestro,133265,94,17.14,0,0,0,0,0,0,0,0,0,0,0,0,0,0,0
Medio_alto,No_siniestro,133359,111,1.3,0,0,0,0,0,0,0,0,0,0,0,0,0,0,0
Medio_alto,No_siniestro,134377,40,6373.84,0,0,0,0,0,0,0,0,0,0,0,0,0,0,0
Medio_alto,No_siniestro,135338,129,0.01,0,0,0,0,1,1,0,2,0,0,0,0,0,0,0
Medio_alto,No_siniestro,135359,107,5855.34,0,0,0,0,0,0,0,0,0,0,0,0,0,0,0
Medio_alto,No_siniestro,136160,39,10108.96,0,0,0,0,0,0,0,0,0,0,0,0,0,0,0
Medio_alto,No_siniestro,139530,39,5549.37,0,0,0,0,0,0,0,0,0,0,0,0,0,0,0
Medio_alto,No_siniestro,142220,39,8532.08,0,0,1,1,0,2,1,5,0,0,0,0,0,0,0
Medio_alto,No_siniestro,143952,76,5831.88,0,0,0,0,0,0,0,0,0,0,0,0,0,0,0
Medio_alto,No_siniestro,146481,54,5415.82,0,0,0,0,0,1,0,1,0,0,0,0,0,0,0
Medio_alto,No_siniestro,147247,27,1437.72,0,0,1,0,0,0,1,2,0,0,0,0,0,0,0
Medio_alto,No_siniestro,148054,65,1202.79,0,0,0,0,1,0,1,2,0,0,0,0,0,0,0
Medio_alto,No_siniestro,150265,26,1976.1,0,0,0,0,0,0,0,0,0,0,0,0,0,0,0
Medio_alto,No_siniestro,152477,39,3297.69,0,0,0,0,0,0,0,0,0,0,0,0,0,0,0
Medio_alto,No_siniestro,155421,87,3737.52,0,0,0,0,0,0,0,0,0,0,0,0,0,0,0
Medio_alto,No_siniestro,156358,62,374.44,0,0,0,0,0,0,0,0,0,0,0,0,0,0,0
Medio_alto,No_siniestro,158210,39,51229.44,133149.72,0,0,0,0,0,0,0,0,0,0,0,0,0,0
Medio_alto,No_siniestro,163650,39,2906.35,0,0,0,0,0,0,1,1,0,0,0,0,0,0,0
Medio_alto,No_siniestro,167194,41,7704.68,0,0,0,0,0,0,0,0,0,0,0,0,0,0,0
Medio_alto,No_siniestro,172587,55,5691.23,91255.11,0,0,0,0,0,0,0,0,0,0,0,0,0,0
Medio_alto,No_siniestro,174093,40,15240.37,0,0,0,0,0,0,0,0,0,0,0,0,0,0,0
Medio_alto,No_siniestro,174682,39,4.8,0,0,0,0,0,0,0,0,0,0,0,0,0,0,0
Medio_alto,No_siniestro,187561,115,52.78,0,0,0,0,0,0,0,0,0,0,0,0,0,0,0
Medio_alto,No_siniestro,188930,49,61.4,0,0,0,0,0,0,0,0,0,0,0,0,0,0,0
Medio_alto,No_siniestro,189461,117,346.87,0,0,0,0,0,0,0,0,0,0,0,0,0,0,0
Medio_alto,No_siniestro,189743,31,57,0,0,0,0,0,0,1,1,0,0,0,0,0,0,0
Medio_alto,No_siniestro,189831,13,3846.43,0,0,0,0,0,0,0,0,0,0,0,0,0,0,0
Medio_alto,No_siniestro,190061,217,23944.86,0,0,0,0,0,0,0,0,0,0,0,0,0,0,0
Medio_alto,No_siniestro,191856,155,19621.7,0,0,0,0,0,0,0,0,0,0,0,0,0,0,0
Medio_alto,No_siniestro,192628,161,3777.02,0,0,0,0,0,0,0,0,0,0,0,0,0,0,0
Medio_alto,No_siniestro,194687,112,259.78,0,0,0,0,0,0,0,0,0,0,0,0,0,0,0
Medio_alto,No_siniestro,195356,161,14191.6,103368.17,0,0,0,0,0,0,0,0,0,0,0,0,0,0
Medio_alto,Si_siniestro,195594,56,19.44,0,1,1,0,0,0,2,4,0,0,0,0,0,0,0
Medio_alto,No_siniestro,196116,121,871.96,0,0,0,0,0,0,0,0,0,0,0,0,0,0,0
Medio_alto,No_siniestro,198210,49,745.43,62632.08,0,0,0,0,0,0,0,0,0,0,0,0,0,0
Medio_alto,No_siniestro,198843,140,11543.01,0,0,0,0,0,0,0,0,0,0,0,0,0,0,0
Medio_alto,No_siniestro,201896,131,8543.79,0,0,0,0,0,0,0,0,0,0,0,0,0,0,0
Medio_alto,No_siniestro,201926,40,53.94,137678.05,0,0,0,0,0,0,0,0,0,0,0,0,0,0
Medio_alto,No_siniestro,202041,102,0.11,0,0,0,0,2,1,0,3,0,0,0,0,0,0,0
Medio_alto,No_siniestro,202471,224,1.62,0,0,0,0,0,0,0,0,0,0,0,0,0,0,0
Medio_alto,No_siniestro,202488,92,6321.66,83042.2,0,0,0,0,0,0,0,0,0,0,0,0,0,0
Medio_alto,No_siniestro,203597,57,2651.97,0,0,0,0,0,0,0,0,0,0,0,0,0,0,0
Medio_alto,No_siniestro,204139,181,10180.08,10423.29,0,0,0,0,0,0,0,0,0,0,0,0,0,0
Medio_alto,No_siniestro,204307,112,33843.63,0,0,0,0,0,0,0,0,0,0,0,0,0,0,0
Medio_alto,No_siniestro,204746,72,4996.75,0,0,0,0,0,0,0,0,0,0,0,0,0,0,0
Medio_alto,No_siniestro,206419,28,49.52,42571.69,0,0,0,0,0,0,0,0,0,0,0,0,0,0
Medio_alto,No_siniestro,207210,49,2354.32,0,0,0,0,0,0,0,0,0,0,0,0,0,0,0
Medio_alto,No_siniestro,207391,45,577.39,0,0,0,0,0,0,0,0,0,0,0,0,0,0,0
Medio_alto,No_siniestro,208208,80,8808.31,45866.87,0,0,0,0,0,0,0,0,0,0,0,0,0,0
Medio_alto,No_siniestro,212992,46,14146.43,178586.7,0,0,0,0,0,0,0,0,0,0,0,0,0,0
Medio_alto,No_siniestro,215667,49,99.99,0,0,0,0,0,0,0,0,0,0,0,0,0,0,0
Medio_alto,No_siniestro,217019,65,9956.7,0,0,0,0,0,0,0,0,0,0,0,0,0,0,0
Medio_alto,No_siniestro,220807,103,739.94,0,0,0,0,0,0,0,0,0,0,0,0,0,0,0
Medio_alto,No_siniestro,221949,42,9062.97,61194.72,0,0,0,0,0,0,0,0,0,0,0,0,0,0
Medio_alto,No_siniestro,222942,69,6690.55,60202.62,0,0,0,0,0,0,0,0,0,0,0,0,0,0
Medio_alto,No_siniestro,222948,32,15957.83,0,0,0,0,0,0,0,0,0,0,0,0,0,0,0
Medio_alto,No_siniestro,223058,6,130.68,0,0,0,0,0,0,0,0,0,0,0,0,0,0,0
Medio_alto,No_siniestro,224101,22,3780.62,0,0,0,0,0,0,0,0,0,0,0,0,0,0,0
Medio_alto,No_siniestro,225021,53,2383.57,0,0,0,0,0,0,0,0,0,0,0,0,0,0,0
Medio_alto,No_siniestro,226594,88,7301.27,0,0,0,0,0,0,0,0,0,0,0,0,0,0,0
Medio_alto,No_siniestro,227202,75,332.1,0,0,0,0,0,0,0,0,0,0,0,0,0,0,0
Medio_alto,No_siniestro,229886,59,1864.75,0,0,0,0,0,0,0,0,0,0,0,0,0,0,0
Medio_alto,No_siniestro,230546,101,20063.81,109482.44,0,0,0,0,0,0,0,0,0,0,0,0,0,0
Medio_alto,No_siniestro,231317,44,718.91,0,0,0,0,0,0,0,0,0,0,0,0,0,0,0
Medio_alto,No_siniestro,231890,49,1555.65,0,0,0,0,0,0,0,0,0,0,0,0,0,0,0
Medio_alto,No_siniestro,240657,86,1156.06,0,0,0,0,0,0,0,0,0,0,0,0,0,0,0
Medio_alto,No_siniestro,250514,55,2956.32,0,0,0,0,0,0,1,1,0,0,0,0,0,0,0
Medio_alto,No_siniestro,252264,33,4773.73,0,0,0,0,0,0,0,0,0,0,0,0,0,0,0
Medio_alto,No_siniestro,254099,77,60.48,0,0,0,0,0,0,0,0,0,0,0,0,0,0,0
Medio_alto,No_siniestro,255124,147,3182.25,0,0,0,0,0,0,0,0,0,0,0,0,0,0,0
Medio_alto,No_siniestro,255477,61,559.22,0,0,0,0,0,0,0,0,0,0,0,0,0,0,0
Medio_alto,No_siniestro,257367,101,4194.9,0,0,0,0,0,0,0,0,0,0,0,0,0,0,0
Medio_alto,No_siniestro,258430,49,85,0,0,0,0,0,0,0,0,0,0,0,0,0,0,0
Medio_alto,No_siniestro,259444,199,1782.76,0,0,0,0,0,0,0,0,0,0,0,0,0,0,0
Medio_alto,No_siniestro,260477,42,373.38,0,0,0,0,0,0,0,0,0,0,0,0,0,0,0
Medio_alto,No_siniestro,260867,54,1400.86,0,0,0,0,0,0,0,0,0,0,0,0,0,0,0
Medio_alto,No_siniestro,261501,109,7504.51,0,1,1,0,0,1,0,3,0,0,0,0,0,0,0
Medio_alto,No_siniestro,261920,49,117.93,0,0,0,0,0,0,0,0,0,0,0,0,0,0,0
Medio_alto,No_siniestro,262174,31,147.82,0,0,0,0,0,0,0,0,0,0,0,0,0,0,0
Medio_alto,No_siniestro,265172,112,159.64,432.07,0,0,0,0,0,0,0,0,0,0,0,0,0,0
Medio_alto,No_siniestro,268013,123,4464.69,0,0,0,0,0,0,0,0,0,0,0,0,0,0,0
Medio_alto,No_siniestro,268459,123,1171.13,13750.42,0,0,0,0,0,0,0,0,0,0,0,0,0,0
Medio_alto,No_siniestro,271347,85,4932.43,0,0,0,0,0,0,0,0,0,0,0,0,0,0,0
Medio_alto,No_siniestro,273025,77,1779.79,0,0,0,0,0,0,0,0,0,0,0,0,0,0,0
Medio_alto,No_siniestro,274703,127,406.51,0,0,0,0,0,0,0,0,0,0,0,0,0,0,0
Medio_alto,No_siniestro,275335,105,18834.13,0,0,0,0,0,0,0,0,0,0,0,0,0,0,0
Medio_alto,No_siniestro,275601,6,15917.24,172211.72,1,0,1,1,0,0,3,0,0,0,0,0,0,0
Medio_alto,No_siniestro,277090,49,820.03,0,0,0,0,0,0,0,0,0,0,0,0,0,0,0
Medio_alto,No_siniestro,278417,43,25124.45,0,0,0,0,0,0,0,0,0,0,0,0,0,0,0
Medio_alto,No_siniestro,279414,108,1434.41,0,0,0,0,0,0,0,0,0,0,0,0,0,0,0
Medio_alto,No_siniestro,279772,168,8144.18,0,0,0,0,0,0,0,0,0,0,0,0,0,0,0
Medio_alto,No_siniestro,282998,103,10341.92,0,0,0,0,0,0,0,0,0,0,0,0,0,0,0
Medio_alto,No_siniestro,286187,164,1895.62,0,1,0,0,0,0,0,1,0,0,0,0,0,0,0
Medio_alto,No_siniestro,297726,100,709.98,56137.27,0,0,0,0,0,0,0,0,0,0,0,0,0,0
Medio_alto,No_siniestro,297768,8,87.57,63068.65,0,0,0,0,0,0,0,0,0,0,0,0,0,0
Medio_alto,No_siniestro,301844,54,5992.99,0,0,0,0,0,0,0,0,0,0,0,0,0,0,0
Medio_alto,No_siniestro,315198,15,332.19,0,0,0,0,0,0,0,0,0,0,0,0,0,0,0
Medio_alto,No_siniestro,317857,122,444.97,0,0,0,0,0,0,0,0,0,0,0,0,0,0,0
Medio_alto,No_siniestro,319471,161,5228.73,0,0,0,0,0,0,0,0,0,0,0,0,0,0,0
Medio_alto,No_siniestro,320069,65,289.18,0,0,0,0,0,0,0,0,0,0,0,0,0,0,0
Medio_alto,No_siniestro,320397,7,579.65,139796.75,0,0,0,0,0,0,0,0,0,0,0,0,0,0
Medio_alto,No_siniestro,322370,44,4795.19,0,1,0,0,0,0,0,1,0,0,0,0,0,0,0
Medio_alto,No_siniestro,322949,184,7379.99,0,0,0,0,0,0,0,0,0,0,0,0,0,0,0
Medio_alto,No_siniestro,326295,121,21277.38,0,0,0,0,0,0,0,0,0,0,0,0,0,0,0
Medio_alto,No_siniestro,330686,46,2341.32,0,0,0,0,0,0,0,0,0,0,0,0,0,0,0
Medio_alto,No_siniestro,330971,51,863.3,0,0,0,0,0,0,0,0,0,0,0,0,0,0,0
Medio_alto,No_siniestro,331083,202,984.99,0,0,0,0,0,1,0,1,0,0,0,0,0,0,0
Medio_alto,No_siniestro,333138,67,1254.54,0,0,0,0,0,0,0,0,0,0,0,0,0,0,0
Medio_alto,No_siniestro,333460,44,6708.32,0,0,0,0,0,0,0,0,0,0,0,0,0,0,0
Medio_alto,No_siniestro,339735,86,894.47,60391.13,0,0,0,0,0,0,0,0,0,0,0,0,0,0
Medio_alto,No_siniestro,343055,22,10869.02,0,0,0,0,0,0,0,0,0,0,0,0,0,0,0
Medio_alto,No_siniestro,344441,134,10476.79,0,0,0,0,0,0,0,0,0,0,0,0,0,0,0
Medio_alto,No_siniestro,346203,92,13534.5,74519.61,0,0,0,0,0,0,0,0,0,0,0,0,0,0
Medio_alto,No_siniestro,346347,92,3208.2,0,0,0,0,0,0,0,0,0,0,0,0,0,0,0
Medio_alto,No_siniestro,346653,32,3182.14,110766.92,0,0,0,0,0,0,0,0,0,0,0,0,0,0
Medio_alto,No_siniestro,347789,180,20321.79,0,0,0,0,0,0,0,0,0,0,0,0,0,0,0
Medio_alto,No_siniestro,347926,9,24122.25,47860.3,0,0,0,0,0,0,0,0,0,0,0,0,0,0
Medio_alto,No_siniestro,350661,67,22020.04,32355.4,0,0,0,0,0,0,0,0,0,0,0,0,0,0
Medio_alto,No_siniestro,351733,30,14655.59,0,0,1,1,1,0,0,3,0,0,0,0,0,0,0
Medio_alto,No_siniestro,352197,110,1126.68,0,0,0,0,0,0,0,0,0,0,0,0,0,0,0
Medio_alto,No_siniestro,354516,127,12077.72,0,0,0,0,0,0,0,0,0,0,0,0,0,0,0
Medio_alto,No_siniestro,354611,66,31451.46,0,0,0,0,0,0,0,0,0,0,0,0,0,0,0
Medio_alto,No_siniestro,357252,109,1983.59,44105.47,0,0,0,0,0,0,0,0,0,0,0,0,0,0
Medio_alto,No_siniestro,383597,209,7002.34,0,0,0,0,0,0,0,0,0,0,0,0,0,0,0
Medio_alto,No_siniestro,384098,163,5290.75,0,0,0,0,0,0,0,0,0,0,0,0,0,0,0
Medio_alto,No_siniestro,385503,105,18586.54,0,0,0,0,0,0,0,0,0,0,0,0,0,0,0
Medio_alto,No_siniestro,387961,112,8762.68,0,0,0,0,0,0,0,0,0,0,0,0,0,0,0
Medio_alto,No_siniestro,388010,44,781.88,0,0,0,0,0,0,0,0,0,0,0,0,0,0,0
Medio_alto,No_siniestro,389896,34,1035.39,0,0,0,0,0,0,0,0,0,0,0,0,0,0,0
Medio_alto,No_siniestro,391935,149,10085.65,0,0,0,0,0,0,0,0,0,0,0,0,0,0,0
Medio_alto,No_siniestro,392183,12,12811.72,0,0,0,0,0,0,0,0,0,0,0,0,0,0,0
Medio_alto,No_siniestro,392532,154,1480.7,0,0,0,0,0,0,0,0,0,0,0,0,0,0,0
Medio_alto,No_siniestro,393318,24,1402.59,0,0,0,0,0,0,0,0,0,0,0,0,0,0,0
Medio_alto,No_siniestro,397256,87,6158.98,0,0,0,0,0,0,0,0,0,0,0,0,0,0,0
Medio_alto,No_siniestro,397892,151,818.07,37339.6,0,0,0,0,0,0,0,0,0,0,0,0,0,0
Medio_alto,No_siniestro,398472,124,2089.52,0,0,0,0,0,0,0,0,0,0,0,0,0,0,0
Medio_alto,No_siniestro,399750,44,12601,0,0,0,0,0,0,0,0,0,0,0,0,0,0,0
Medio_alto,No_siniestro,401024,162,7367.13,0,0,0,0,0,0,0,0,0,0,0,0,0,0,0
Medio_alto,No_siniestro,402604,21,0.06,0,0,0,0,0,0,0,0,0,0,0,0,0,0,0
Medio_alto,No_siniestro,403432,98,770.6,32088.5,0,0,0,0,0,0,0,0,0,0,0,0,0,0
Medio_alto,No_siniestro,404001,20,4.29,49225.39,0,0,0,0,0,0,0,0,0,0,0,0,0,0
Medio_alto,No_siniestro,404120,44,8691.07,0,0,0,0,0,0,0,0,0,0,0,0,0,0,0
Medio_alto,No_siniestro,405923,34,2622.62,0,0,0,0,0,0,0,0,0,0,0,0,0,0,0
Medio_alto,No_siniestro,407514,120,6821.91,0,0,0,0,0,0,0,0,0,0,0,0,0,0,0
Medio_alto,No_siniestro,407900,44,5535.49,0,0,0,0,0,0,0,0,0,0,0,0,0,0,0
Medio_alto,No_siniestro,409086,141,21785.28,0,0,0,0,0,0,0,0,0,0,0,0,0,0,0
Medio_alto,No_siniestro,409717,91,9176.27,0,0,0,0,0,0,0,0,0,0,0,0,0,0,0
Medio_alto,No_siniestro,414172,67,27105.38,0,1,0,0,1,1,0,3,0,0,0,0,0,0,0
Medio_alto,No_siniestro,414828,176,28620.84,0,0,0,0,0,0,0,0,0,0,0,0,0,0,0
Medio_alto,No_siniestro,415748,65,7901.69,61883.91,0,0,0,0,0,0,0,0,0,0,0,0,0,0
Medio_alto,No_siniestro,419118,128,1512.16,0,0,0,0,0,0,0,0,0,0,0,0,0,0,0
Medio_alto,No_siniestro,420813,31,14628.36,0,0,0,0,0,0,0,0,0,0,0,0,0,0,0
Medio_alto,No_siniestro,421976,67,604.7,0,0,0,0,0,0,0,0,0,0,0,0,0,0,0
Medio_alto,No_siniestro,422319,69,14475.34,0,0,0,0,0,0,0,0,0,0,0,0,0,0,0
Medio_alto,No_siniestro,424572,89,317.93,0,0,0,0,0,0,0,0,0,0,0,0,0,0,0
Medio_alto,No_siniestro,447819,28,3.19,118502.33,0,0,0,0,0,0,0,0,0,0,0,0,0,0
Medio_alto,No_siniestro,449355,63,834.26,0,0,0,0,0,0,0,0,0,0,0,0,0,0,0
Medio_alto,No_siniestro,451725,161,1382.53,0,0,0,0,0,0,0,0,0,0,0,0,0,0,0
Medio_alto,No_siniestro,452506,122,8583.7,0,0,0,0,0,0,0,0,0,0,0,0,0,0,0
Medio_alto,No_siniestro,457191,118,2750.13,0,0,0,0,0,0,0,0,0,0,0,0,0,0,0
Medio_alto,No_siniestro,458008,87,1490.04,0,0,0,0,0,0,0,0,0,0,0,0,0,0,0
Medio_alto,No_siniestro,459101,37,6739.73,0,0,0,0,0,0,0,0,0,0,0,0,0,0,0
Medio_alto,No_siniestro,460652,167,1863.9,0,0,0,0,0,0,0,0,0,0,0,0,0,0,0
Medio_alto,No_siniestro,461238,13,2108.4,71703.34,0,0,0,0,0,0,0,0,0,0,0,0,0,0
Medio_alto,No_siniestro,462288,58,1588.12,28900.45,0,0,0,0,0,0,0,0,0,0,0,0,0,0
Medio_alto,No_siniestro,462472,153,18813.31,69923.75,0,1,0,1,1,0,3,0,0,0,0,0,0,0
Medio_alto,No_siniestro,465500,40,9868.7,31551.37,0,0,0,0,0,0,0,0,0,0,0,0,0,0
Medio_alto,No_siniestro,465957,125,6131.74,62019.47,0,0,0,0,0,0,0,0,0,0,0,0,0,0
Medio_alto,No_siniestro,465967,110,167.51,0,0,0,0,0,0,0,0,0,0,0,0,0,0,0
Medio_alto,No_siniestro,467011,227,6789.9,54829.33,0,0,0,0,0,0,0,0,0,0,0,0,0,0
Medio_alto,No_siniestro,468490,40,10913.01,0,0,0,0,0,0,0,0,0,0,0,0,0,0,0
Medio_alto,No_siniestro,468493,181,539.74,37916.27,0,0,0,0,0,0,0,0,0,0,0,0,0,0
Medio_alto,No_siniestro,470110,40,5672.27,0,0,0,0,0,0,0,0,0,0,0,0,0,0,0
Medio_alto,No_siniestro,470282,90,593.53,0,0,0,0,0,0,0,0,0,0,0,0,0,0,0
Medio_alto,No_siniestro,470427,116,11756.97,0,0,0,0,0,0,0,0,0,0,0,0,0,0,0
Medio_alto,No_siniestro,474267,163,25130.93,44718.47,0,0,0,0,0,0,0,0,0,0,0,0,0,0
Medio_alto,No_siniestro,474765,21,663.35,56031.49,0,0,0,0,0,0,0,0,0,0,0,0,0,0
Medio_alto,No_siniestro,475632,172,33492.8,24711.93,0,0,1,0,0,0,1,0,0,0,0,0,0,0
Medio_alto,No_siniestro,476006,60,4226.74,0,0,0,0,0,0,0,0,0,0,0,0,0,0,0
Medio_alto,No_siniestro,478845,33,2265.98,8758.51,0,0,0,0,0,0,0,0,0,0,0,0,0,0
Medio_alto,No_siniestro,482828,67,1199.21,0,0,0,0,0,0,0,0,0,0,0,0,0,0,0
Medio_alto,No_siniestro,484029,34,4703.53,0,0,0,0,0,0,0,0,0,0,0,0,0,0,0
Medio_alto,No_siniestro,484122,144,20929.55,24592.33,0,0,0,0,0,0,0,0,0,0,0,0,0,0
Medio_alto,No_siniestro,486194,67,73.67,43573.23,0,0,0,0,0,0,0,0,0,0,0,0,0,0
Medio_alto,No_siniestro,486942,80,11059.3,0,0,0,0,0,1,0,1,0,0,0,0,0,0,0
Medio_alto,No_siniestro,490345,135,4403.12,92765.82,0,0,0,0,0,0,0,0,0,0,0,0,0,0
Medio_alto,No_siniestro,490596,81,9052.86,28285.68,0,0,0,0,0,0,0,0,0,0,0,0,0,0
Medio_alto,No_siniestro,496807,96,99.81,0,0,0,0,0,0,0,0,0,0,0,0,0,0,0
Medio_alto,No_siniestro,497430,40,3530.15,0,0,0,0,0,0,0,0,0,0,0,0,0,0,0
Medio_alto,No_siniestro,512226,42,12315.14,0,1,0,0,0,0,0,1,0,0,0,0,0,0,0
Medio_alto,No_siniestro,514667,43,60.81,0,0,0,0,0,0,0,0,0,0,0,0,0,0,0
Medio_alto,No_siniestro,514694,31,31.83,0,0,0,0,0,0,0,0,0,0,0,0,0,0,0
Medio_alto,No_siniestro,514907,71,2251.18,0,0,0,0,0,0,0,0,0,0,0,0,0,0,0
Medio_alto,No_siniestro,515609,132,3191.32,0,0,0,0,0,0,0,0,0,0,0,0,0,0,0
Medio_alto,No_siniestro,515969,9,112.98,0,0,0,0,0,0,0,0,0,0,0,0,0,0,0
Medio_alto,No_siniestro,518614,231,7341.15,0,0,0,0,0,0,0,0,0,0,0,0,0,0,0
Medio_alto,No_siniestro,519175,33,236.28,0,0,0,0,0,0,0,0,0,0,0,0,0,0,0
Medio_alto,No_siniestro,521422,85,2570.42,36429.08,0,0,0,0,0,0,0,0,0,0,0,0,0,0
Medio_alto,No_siniestro,523930,40,678.86,0,0,0,0,0,0,0,0,0,0,0,0,0,0,0
Medio_alto,No_siniestro,525739,119,3514.75,0,0,0,0,0,0,0,0,0,0,0,0,0,0,0
Medio_alto,No_siniestro,526246,66,4408.62,0,0,0,0,0,0,0,0,0,0,0,0,0,0,0
Medio_alto,No_siniestro,527145,166,33461.54,92013.4,0,0,0,0,0,0,0,0,0,0,0,0,0,0
Medio_alto,No_siniestro,528301,40,1356.71,0,0,0,0,0,0,0,0,0,0,0,0,0,0,0
Medio_alto,No_siniestro,529944,7,1724.01,0,0,0,0,0,0,0,0,0,0,0,0,0,0,0
Medio_alto,No_siniestro,532082,87,20924.63,34658.87,0,0,0,0,0,0,0,0,0,0,0,0,0,0
Medio_alto,No_siniestro,532839,70,5802.8,157761.78,0,0,0,0,0,0,0,0,0,0,0,0,0,0
Medio_alto,No_siniestro,534556,64,6173.5,0,0,0,0,0,0,0,0,0,0,0,0,0,0,0
Medio_alto,No_siniestro,534592,61,3120.98,0,0,0,0,0,0,0,0,0,0,0,0,0,0,0
Medio_alto,No_siniestro,535921,79,10894.95,0,0,0,0,0,0,0,0,0,0,0,0,0,0,0
Medio_alto,No_siniestro,536188,32,12345.31,0,0,0,0,0,0,0,0,0,0,0,0,0,0,0
Medio_alto,No_siniestro,536432,32,8147.18,0,0,0,0,0,0,0,0,0,0,0,0,0,0,0
Medio_alto,No_siniestro,539079,144,1592.13,0,0,0,0,0,0,0,0,0,0,0,0,0,0,0
Medio_alto,No_siniestro,539521,19,16328.82,59259.62,0,0,0,0,0,0,0,0,0,0,0,0,0,0
Medio_alto,No_siniestro,540111,217,18814.28,76821.18,0,0,0,0,0,0,0,0,0,0,0,0,0,0
Medio_alto,No_siniestro,541692,78,2604.73,0,0,0,0,0,0,0,0,0,0,0,0,0,0,0
Medio_alto,No_siniestro,541933,186,14810.96,0,0,0,0,0,0,0,0,0,0,0,0,0,0,0
Medio_alto,No_siniestro,544261,112,0.04,0,0,0,0,0,0,0,0,0,0,0,0,0,0,0
Medio_alto,No_siniestro,545825,23,8775.03,0,0,0,0,0,0,0,0,0,0,0,0,0,0,0
Medio_alto,No_siniestro,546016,20,3203.59,0,0,0,0,0,0,0,0,0,0,0,0,0,0,0
Medio_alto,Si_siniestro,548825,92,3181.91,52191.15,1,4,3,2,1,0,11,0,0,0,0,0,0,0
Medio_alto,No_siniestro,550165,13,1580.42,0,0,0,0,0,0,0,0,0,0,0,0,0,0,0
Medio_alto,No_siniestro,551388,126,5345.78,10504.39,0,0,0,0,0,0,0,0,0,0,0,0,0,0
Medio_alto,No_siniestro,551984,61,3328.36,0,0,0,0,0,0,0,0,0,0,0,0,0,0,0
Medio_alto,No_siniestro,552185,59,10156.25,0,0,0,0,0,0,0,0,0,0,0,0,0,0,0
Medio_alto,No_siniestro,553086,154,11379.63,0,0,0,0,0,0,0,0,0,0,0,0,0,0,0
Medio_alto,No_siniestro,556570,40,164.87,111380.56,0,0,0,0,0,0,0,0,0,0,0,0,0,0
Medio_alto,No_siniestro,559031,6,0.11,0,0,0,0,0,0,0,0,0,0,0,0,0,0,0
Medio_alto,No_siniestro,561852,55,1002.54,0,0,0,0,0,0,0,0,0,0,0,0,0,0,0
Medio_alto,No_siniestro,561887,94,558.43,0,0,0,0,0,0,0,0,0,0,0,0,0,0,0
Medio_alto,No_siniestro,563846,14,1350.16,41722.87,0,0,0,0,0,0,0,0,0,0,0,0,0,0
Medio_alto,No_siniestro,566691,10,13996.02,69502.65,0,0,0,0,0,0,0,0,0,0,0,0,0,0
Medio_alto,No_siniestro,573844,49,9996.18,103867.97,0,0,0,0,0,0,0,0,0,0,0,0,0,0
Medio_alto,Si_siniestro,579610,40,14793.96,0,1,0,0,0,0,0,1,0,0,0,0,0,0,0
Medio_alto,No_siniestro,582297,56,3889.74,0,0,0,0,0,0,0,0,0,0,0,0,0,0,0
Medio_alto,No_siniestro,583214,130,706.73,3937.53,0,0,0,0,0,0,0,0,0,0,0,0,0,0
Medio_alto,No_siniestro,583636,191,1088.37,49222.33,0,0,0,0,0,0,0,0,0,0,0,0,0,0
Medio_alto,No_siniestro,585588,88,498.24,0,0,0,0,0,0,0,0,0,0,0,0,0,0,0
Medio_alto,No_siniestro,586239,32,83.43,0,0,0,0,0,0,0,0,0,0,0,0,0,0,0
Medio_alto,No_siniestro,586616,83,411.52,67888.95,0,0,0,0,0,0,0,0,0,0,0,0,0,0
Medio_alto,No_siniestro,591327,72,177.67,0,0,0,0,0,0,0,0,0,0,0,0,0,0,0
Medio_alto,No_siniestro,591774,62,547.4,0,0,0,0,0,0,0,0,0,0,0,0,0,0,0
Medio_alto,No_siniestro,591797,34,2399.06,0,0,0,0,0,0,0,0,0,0,0,0,0,0,0
Medio_alto,No_siniestro,592336,155,10690.96,0,0,0,0,0,0,0,0,0,0,0,0,0,0,0
Medio_alto,No_siniestro,593418,70,38994.6,0,0,0,0,0,0,0,0,0,0,0,0,0,0,0
Medio_alto,No_siniestro,594214,20,9690.06,52766.9,0,0,0,0,0,0,0,0,0,0,0,0,0,0
Medio_alto,No_siniestro,594280,40,222.79,24930.57,0,0,0,0,0,0,0,0,0,0,0,0,0,0
Medio_alto,No_siniestro,594804,96,3019.41,0,0,0,0,0,0,0,0,0,0,0,0,0,0,0
Medio_alto,No_siniestro,595525,185,8465.93,0,0,0,0,0,0,0,0,0,0,0,0,0,0,0
Medio_alto,No_siniestro,596421,27,17102.2,0,0,0,0,0,0,0,0,0,0,0,0,0,0,0
Medio_alto,No_siniestro,597857,81,16235.07,0,0,0,0,0,0,0,0,0,0,0,0,0,0,0
Medio_alto,No_siniestro,598817,120,54048.74,8024,0,0,0,0,0,0,0,0,0,0,0,0,0,0
Medio_alto,No_siniestro,601134,56,4358.38,0,0,0,0,0,0,0,0,0,0,0,0,0,0,0
Medio_alto,No_siniestro,602687,127,30594.53,91457.55,0,0,0,0,0,0,0,0,0,0,0,0,0,0
Medio_alto,No_siniestro,602996,186,1086.11,173141.39,0,0,0,0,0,0,0,0,0,0,0,0,0,0
Medio_alto,No_siniestro,603742,103,63.4,0,0,0,0,0,0,0,0,0,0,0,0,0,0,0
Medio_alto,No_siniestro,604249,21,4458.86,0,0,0,0,0,0,0,0,0,0,0,0,0,0,0
Medio_alto,No_siniestro,606856,68,3523.75,0,0,0,0,0,0,0,0,0,0,0,0,0,0,0
Medio_alto,No_siniestro,607378,148,14195.17,0,0,0,0,0,0,0,0,0,0,0,0,0,0,0
Medio_alto,No_siniestro,608100,40,10340.29,39073.32,0,0,0,0,0,0,0,0,0,0,0,0,0,0
Medio_alto,No_siniestro,608493,27,16448.01,63838.9,0,0,0,0,0,0,0,0,0,0,0,0,0,0
Medio_alto,No_siniestro,608671,122,2529.54,0,0,0,0,0,0,0,0,0,0,0,0,0,0,0
Medio_alto,No_siniestro,609333,59,2598.3,0,0,0,0,0,0,0,0,0,0,0,0,0,0,0
Medio_alto,No_siniestro,609773,82,10.31,0,0,0,0,0,0,0,0,0,0,0,0,0,0,0
Medio_alto,No_siniestro,611146,55,1745,0,0,0,0,0,0,0,0,0,0,0,0,0,0,0
Medio_alto,No_siniestro,612137,54,18498.96,129412.77,0,0,0,0,0,0,0,0,0,0,0,0,0,0
Medio_alto,No_siniestro,613410,40,2278.66,0,0,0,0,0,0,0,0,0,0,0,0,0,0,0
Medio_alto,No_siniestro,614878,60,23599.28,0,0,0,0,0,0,0,0,0,0,0,0,0,0,0
Medio_alto,No_siniestro,621039,11,391.88,0,0,0,0,0,0,0,0,0,0,0,0,0,0,0
Medio_alto,No_siniestro,621337,25,1625.64,109547.01,0,0,0,0,0,0,0,0,0,0,0,0,0,0
Medio_alto,No_siniestro,631700,43,14767.26,0,0,0,0,0,0,0,0,0,0,0,0,0,0,0
Medio_alto,No_siniestro,632543,109,4985.19,0,0,0,0,0,0,0,0,0,0,0,0,0,0,0
Medio_alto,No_siniestro,635341,70,6096.42,0,0,0,0,0,0,0,0,0,0,0,0,0,0,0
Medio_alto,No_siniestro,650365,73,643.72,0,0,0,0,0,0,0,0,0,0,0,0,0,0,0
Medio_alto,No_siniestro,651196,16,6435.74,0,0,0,0,0,0,0,0,0,0,0,0,0,0,0
Medio_alto,No_siniestro,652570,43,333.08,17339.95,0,0,0,0,0,0,0,0,0,0,0,0,0,0
Medio_alto,No_siniestro,653296,11,3270.91,47240.74,0,0,0,0,0,0,0,0,0,0,0,0,0,0
Medio_alto,No_siniestro,655016,125,8149.86,90184.95,0,0,0,0,0,0,0,0,0,0,0,0,0,0
Medio_alto,No_siniestro,658386,19,4232.82,0,0,0,0,0,0,0,0,0,0,0,0,0,0,0
Medio_alto,No_siniestro,660700,43,4922.08,18245.29,0,0,0,0,0,0,0,0,0,0,0,0,0,0
Medio_alto,No_siniestro,660938,37,12252.99,0,0,1,0,0,0,0,1,0,0,0,0,0,0,0
Medio_alto,No_siniestro,662081,33,7932.77,0,0,0,0,0,0,0,0,0,0,0,0,0,0,0
Medio_alto,No_siniestro,662365,120,606.58,21281.97,0,0,0,0,0,0,0,0,0,0,0,0,0,0
Medio_alto,No_siniestro,664026,26,784.01,0,0,0,0,0,0,0,0,0,0,0,0,0,0,0
Medio_alto,No_siniestro,664622,124,13757.51,0,0,0,0,0,0,0,0,0,0,0,0,0,0,0
Medio_alto,No_siniestro,669194,126,1216.51,46809.01,0,0,0,0,0,0,0,0,0,0,0,0,0,0
Medio_alto,No_siniestro,670501,164,15.66,0,0,0,0,0,0,0,0,0,0,0,0,0,0,0
Medio_alto,No_siniestro,671254,82,769.1,0,0,0,0,0,0,0,0,0,0,0,0,0,0,0
Medio_alto,No_siniestro,674838,131,5043.66,25434.4,0,0,0,0,0,0,0,0,0,0,0,0,0,0
Medio_alto,No_siniestro,676128,72,4331.84,0,0,0,0,0,0,0,0,0,0,0,0,0,0,0
Medio_alto,No_siniestro,679012,214,23562.47,171240.14,0,0,0,0,0,0,0,0,0,0,0,0,0,0
Medio_alto,No_siniestro,680511,128,1282.79,0,0,0,0,0,0,0,0,0,0,0,0,0,0,0
Medio_alto,No_siniestro,681960,43,8072.73,0,0,1,0,0,0,0,1,0,0,0,0,0,0,0
Medio_alto,No_siniestro,682472,145,8700.96,0,0,0,0,0,0,0,0,0,0,0,0,0,0,0
Medio_alto,No_siniestro,682963,66,18630.44,0,0,0,0,0,0,0,0,0,0,0,0,0,0,0
Medio_alto,No_siniestro,684270,43,9665.07,0,0,0,0,0,0,0,0,0,0,0,0,0,0,0
Medio_alto,No_siniestro,685689,119,4166.97,0,0,0,0,0,0,0,0,0,0,0,0,0,0,0
Medio_alto,No_siniestro,690259,85,18139.59,0,0,0,0,0,0,0,0,0,0,0,0,0,0,0
Medio_alto,No_siniestro,693672,142,1013.35,123638.31,0,0,0,0,0,0,0,0,0,0,0,0,0,0
Medio_alto,No_siniestro,696426,17,15761.47,0,0,0,0,0,0,0,0,0,0,0,0,0,0,0
Medio_alto,No_siniestro,698137,12,18861.34,82689.33,0,0,0,0,0,0,0,0,0,0,0,0,0,0
Medio_alto,No_siniestro,698331,49,71221.61,0,1,0,0,1,1,1,4,0,0,0,0,0,0,0
Medio_alto,No_siniestro,699573,113,1312.26,0,0,0,0,0,0,0,0,0,0,0,0,0,0,0
Medio_alto,No_siniestro,704461,47,302.19,0,0,0,0,0,0,0,0,0,0,0,0,0,0,0
Medio_alto,No_siniestro,723182,119,133.37,0,0,0,0,0,0,0,0,0,0,0,0,0,0,0
Medio_alto,No_siniestro,724789,95,17453.58,0,0,0,0,0,0,0,0,0,0,0,0,0,0,0
Medio_alto,No_siniestro,724897,115,1345.02,0,0,0,0,0,0,0,0,0,0,0,0,0,0,0
Medio_alto,No_siniestro,725288,111,4935.45,6940.85,0,0,0,0,0,0,0,0,0,0,0,0,0,0
Medio_alto,No_siniestro,726288,121,999.53,0,0,0,0,0,0,0,0,0,0,0,0,0,0,0
Medio_alto,No_siniestro,726841,128,10125.69,0,0,0,0,0,0,0,0,0,0,0,0,0,0,0
Medio_alto,No_siniestro,728130,43,32330.01,0,0,0,0,0,0,0,0,0,0,0,0,0,0,0
Medio_alto,No_siniestro,728896,80,8654.36,0,0,0,0,0,0,0,0,0,0,0,0,0,0,0
Medio_alto,No_siniestro,733552,207,1170.2,0,0,0,0,0,0,0,0,0,0,0,0,0,0,0
Medio_alto,No_siniestro,733582,107,1146.69,22602.14,0,0,0,0,0,0,0,0,0,0,0,0,0,0
Medio_alto,No_siniestro,733840,43,38632.33,54404.66,0,0,1,1,1,1,4,0,0,0,0,0,0,0
Medio_alto,No_siniestro,734158,17,4213.71,0,0,0,0,0,0,0,0,0,0,0,0,0,0,0
Medio_alto,No_siniestro,734363,135,7853.76,0,0,0,0,0,0,0,0,0,0,0,0,0,0,0
Medio_alto,No_siniestro,734952,12,7315.51,0,0,0,0,0,0,0,0,0,0,0,0,0,0,0
Medio_alto,No_siniestro,735722,152,4517.6,0,0,0,0,0,0,0,0,0,0,0,0,0,0,0
Medio_alto,No_siniestro,736883,143,126.98,0,0,0,1,0,0,0,1,0,0,0,0,0,0,0
Medio_alto,No_siniestro,737837,93,9120.92,0,0,0,0,0,0,0,0,0,0,0,0,0,0,0
Medio_alto,No_siniestro,738069,206,1105.56,0,0,0,0,0,0,0,0,0,0,0,0,0,0,0
Medio_alto,No_siniestro,738080,43,41.93,0,0,0,0,0,0,0,0,0,0,0,0,0,0,0
Medio_alto,No_siniestro,738504,191,2862.02,0,0,0,0,0,0,0,0,0,0,0,0,0,0,0
Medio_alto,No_siniestro,738602,86,8740.75,0,0,0,0,0,0,0,0,0,0,0,0,0,0,0
Medio_alto,No_siniestro,739095,128,1929.76,0,0,0,0,0,0,0,0,0,0,0,0,0,0,0
Medio_alto,No_siniestro,740107,123,4268.55,0,0,0,0,0,0,0,0,0,0,0,0,0,0,0
Medio_alto,No_siniestro,740924,56,16241.93,0,0,0,0,0,0,0,0,0,0,0,0,0,0,0
Medio_alto,No_siniestro,743864,128,2677.14,36654.97,0,0,0,0,0,0,0,0,0,0,0,0,0,0
Medio_alto,No_siniestro,747405,34,11943.48,0,0,0,0,0,0,0,0,0,0,0,0,0,0,0
Medio_alto,No_siniestro,748063,44,12224.64,0,0,0,0,0,0,0,0,0,0,0,0,0,0,0
Medio_alto,No_siniestro,750065,16,793.8,0,0,0,0,0,0,0,0,0,0,0,0,0,0,0
Medio_alto,No_siniestro,756995,10,61.99,117458.36,0,0,0,0,0,0,0,0,0,0,0,0,0,0
Medio_alto,No_siniestro,758620,43,6561.43,0,0,0,0,0,0,0,0,0,0,0,0,0,0,0
Medio_alto,No_siniestro,759139,51,4638.91,122912.84,0,0,0,0,0,0,0,0,0,0,0,0,0,0
Medio_alto,No_siniestro,759651,46,26.92,0,0,0,0,0,0,0,0,0,0,0,0,0,0,0
Medio_alto,No_siniestro,759661,110,8361.86,0,0,0,0,0,0,0,0,0,0,0,0,0,0,0
Medio_alto,No_siniestro,762107,8,5535.63,0,0,0,0,0,0,0,0,0,0,0,0,0,0,0
Medio_alto,No_siniestro,764733,32,38158.9,64237.25,0,0,0,0,0,0,0,0,0,0,0,0,0,0
Medio_alto,No_siniestro,764773,89,10710.2,0,0,0,0,0,0,0,0,0,0,0,0,0,0,0
Medio_alto,No_siniestro,766148,23,22900.86,43247.13,0,0,0,0,0,0,0,0,0,0,0,0,0,0
Medio_alto,No_siniestro,767339,73,13144.38,57659.59,0,0,0,0,0,0,0,0,0,0,0,0,0,0
Medio_alto,No_siniestro,768293,27,12098.3,0,0,0,0,0,0,0,0,0,0,0,0,0,0,0
Medio_alto,No_siniestro,769304,32,812.73,44952.66,0,0,0,0,0,0,0,0,0,0,0,0,0,0
Medio_alto,No_siniestro,789119,7,12002.39,0,0,0,0,0,0,0,0,0,0,0,0,0,0,0
Medio_alto,No_siniestro,3426,65,0,0,0,2,1,0,0,0,3,0,0,0,0,0,0,0
Medio_alto,No_siniestro,7380,43,0,38663.05,0,0,0,0,0,0,0,0,0,0,0,0,0,0
Medio_alto,No_siniestro,7930,43,99.8,0,0,0,0,0,0,0,0,0,0,0,0,0,0,0
Medio_alto,No_siniestro,64205,102,0,15416.15,0,0,0,0,0,0,0,0,0,0,0,0,0,0
Medio_alto,No_siniestro,87167,1,11097.39,0,0,0,0,0,0,0,0,0,0,0,0,0,0,0
Medio_alto,No_siniestro,94217,119,15329.29,172526.85,1,0,0,0,0,0,1,0,0,0,0,0,0,0
Medio_alto,No_siniestro,97211,0,14.65,36131.91,0,0,0,0,0,0,0,0,0,0,0,0,0,0
Medio_alto,No_siniestro,136222,77,0,0,0,0,1,1,2,1,5,0,0,0,0,0,0,0
Medio_alto,No_siniestro,139073,86,0,0,0,0,0,0,0,0,0,0,0,0,0,0,0,0
Medio_alto,No_siniestro,140041,58,417.07,0,0,0,0,0,0,0,0,0,0,0,0,0,0,0
Medio_alto,No_siniestro,156324,4,9425.22,175043.32,0,0,0,0,0,0,0,0,0,0,0,0,0,0
Medio_alto,No_siniestro,195862,137,0,22228.39,0,0,0,0,0,0,0,0,0,0,0,0,0,0
Medio_alto,No_siniestro,212512,192,0,0,0,0,0,0,0,0,0,0,0,0,0,0,0,0
Medio_alto,No_siniestro,254516,51,0,0,0,0,0,0,0,0,0,0,0,0,0,0,0,0
Medio_alto,No_siniestro,282914,43,0,0,0,0,0,0,0,0,0,0,0,0,0,0,0,0
Medio_alto,No_siniestro,351691,57,1535.05,0,0,0,0,0,0,0,0,0,0,0,0,0,0,0
Medio_alto,No_siniestro,357144,2,38568.76,0,0,0,0,0,0,0,0,0,0,0,0,0,0,0
Medio_alto,No_siniestro,369783,1,25378.98,0,0,0,0,0,0,0,0,0,0,0,0,0,0,0
Medio_alto,No_siniestro,405248,3,510.88,67515.46,0,0,0,0,0,0,0,0,0,0,0,0,0,0
Medio_alto,No_siniestro,417959,15,22849.36,0,0,0,0,0,0,0,0,0,0,0,0,0,0,0
Medio_alto,No_siniestro,474149,1,12.75,0,0,0,0,0,0,0,0,0,0,0,0,0,0,0
Medio_alto,No_siniestro,516180,42,0.02,0,0,0,0,0,0,0,0,0,0,0,0,0,0,0
Medio_alto,No_siniestro,525968,23,0,0,0,0,0,0,0,0,0,0,0,0,0,0,0,0
Medio_alto,No_siniestro,556152,57,0,0,0,0,0,0,0,0,0,0,0,0,0,0,0,0
Medio_alto,No_siniestro,657205,118,0,35306.64,0,0,0,0,0,0,0,0,0,0,0,0,0,0
Medio_alto,No_siniestro,660368,172,0,0,0,0,0,0,0,0,0,0,0,0,0,0,0,0
Medio_alto,No_siniestro,662165,49,0,0,0,0,0,0,0,0,0,0,0,0,0,0,0,0
Medio_alto,No_siniestro,666089,93,0,78349.72,0,0,0,0,0,0,0,0,0,0,0,0,0,0
Medio_alto,No_siniestro,723379,29,0,134335.08,0,0,0,0,0,0,0,0,0,0,0,0,0,0
Medio_alto,No_siniestro,738860,42,969.95,0,0,0,0,0,1,0,1,0,0,0,0,0,0,0
Medio_alto,No_siniestro,788544,5,15146.47,123329.24,0,0,0,0,0,0,0,0,0,0,0,0,0,0
Medio,No_siniestro,33537,11,2785.63,0,0,1,0,0,1,1,3,0,0,0,0,0,0,0
Medio,No_siniestro,37322,26,144.37,0,0,0,0,0,0,0,0,0,0,0,0,0,0,0
Medio,No_siniestro,41796,44,19656.75,0,0,0,0,0,0,0,0,0,0,0,0,0,0,0
Medio,No_siniestro,43772,34,1065,0,0,0,0,0,0,0,0,0,0,0,0,0,0,0
Medio,No_siniestro,50950,39,190.96,0,0,0,0,0,0,0,0,0,0,0,0,0,0,0
Medio,No_siniestro,51725,92,1129.35,0,0,0,0,0,0,0,0,0,0,0,0,0,0,0
Medio,No_siniestro,51742,23,3069.11,0,0,0,0,0,0,0,0,0,0,0,0,0,0,0
Medio,No_siniestro,51941,22,591.14,0,0,0,0,0,0,0,0,0,0,0,0,0,0,0
Medio,No_siniestro,54951,27,11239.75,0,0,1,0,0,0,0,1,0,0,0,0,0,0,0
Medio,No_siniestro,54987,62,1778.89,0,0,0,0,0,0,0,0,0,0,0,0,0,0,0
Medio,No_siniestro,55602,19,975.37,0,0,0,0,0,0,1,1,0,0,0,0,0,0,0
Medio,No_siniestro,102141,32,140,0,0,0,0,0,0,0,0,0,0,0,0,0,0,0
Medio,No_siniestro,104233,63,0.11,0,0,0,0,0,0,0,0,0,0,0,0,0,0,0
Medio,No_siniestro,110602,18,2005.02,0,0,0,0,0,0,0,0,0,0,0,0,0,0,0
Medio,No_siniestro,113484,80,16279.12,0,0,0,0,0,0,0,0,0,0,0,0,0,0,0
Medio,No_siniestro,113977,47,1478.78,0,0,0,0,1,0,0,1,0,0,0,0,0,0,0
Medio,No_siniestro,115087,28,2034.71,54894.87,0,0,0,0,0,0,0,0,0,0,0,0,0,0
Medio,No_siniestro,115850,39,5522.9,0,0,0,0,0,0,0,0,0,0,0,0,0,0,0
Medio,No_siniestro,116022,21,9687.52,0,0,0,0,0,0,0,0,0,0,0,0,0,0,0
Medio,No_siniestro,118525,14,3795.85,0,0,0,0,0,0,0,0,0,0,0,0,0,0,0
Medio,No_siniestro,121182,10,393.26,0,0,0,0,0,0,0,0,0,0,0,0,0,0,0
Medio,No_siniestro,122933,37,93.3,0,0,0,0,1,0,0,1,0,0,0,0,0,0,0
Medio,No_siniestro,124712,10,619.19,0,0,0,0,0,0,0,0,0,0,0,0,0,0,0
Medio,No_siniestro,162488,19,1054.57,8879.8,0,0,0,0,0,0,0,0,0,0,0,0,0,0
Medio,No_siniestro,164270,49,4318.94,0,0,0,0,0,0,0,0,0,0,0,0,0,0,0
Medio,No_siniestro,177089,99,13445.87,0,0,0,0,0,0,0,0,0,0,0,0,0,0,0
Medio,No_siniestro,178341,44,1115.53,0,0,0,0,0,0,0,0,0,0,0,0,0,0,0
Medio,No_siniestro,178895,38,741.08,0,0,0,0,1,0,0,1,0,0,0,0,0,0,0
Medio,No_siniestro,179545,45,9758.61,0,0,0,0,0,0,0,0,0,0,0,0,0,0,0
Medio,No_siniestro,181958,21,200.35,0,0,0,0,0,0,0,0,0,0,0,0,0,0,0
Medio,No_siniestro,182884,22,6894.77,0,0,0,0,0,0,0,0,0,0,0,0,0,0,0
Medio,Si_siniestro,183003,34,1730.39,0,0,0,0,0,0,0,0,0,0,0,0,0,0,0
Medio,No_siniestro,186072,14,8411.85,0,0,0,0,0,0,0,0,0,0,0,0,0,0,0
Medio,No_siniestro,218201,61,674.84,0,0,0,0,0,0,0,0,0,0,0,0,0,0,0
Medio,No_siniestro,227783,7,658.08,0,0,0,0,0,0,0,0,0,0,0,0,0,0,0
Medio,No_siniestro,227975,40,592.83,0,0,0,0,0,0,0,0,0,0,0,0,0,0,0
Medio,No_siniestro,231715,10,521.95,0,0,0,0,0,0,0,0,0,0,0,0,0,0,0
Medio,No_siniestro,239849,8,1418.15,0,0,0,0,0,0,0,0,0,0,0,0,0,0,0
Medio,No_siniestro,241470,49,8123.6,0,0,0,0,0,0,0,0,0,0,0,0,0,0,0
Medio,No_siniestro,242010,49,15.66,0,0,0,0,0,0,0,0,0,0,0,0,0,0,0
Medio,No_siniestro,249848,51,6026.18,0,0,0,0,0,0,0,0,0,0,0,0,0,0,0
Medio,No_siniestro,250887,17,4.41,0,0,0,0,0,0,0,0,0,0,0,0,0,0,0
Medio,No_siniestro,280654,82,15881.82,0,0,0,0,0,0,0,0,0,0,0,0,0,0,0
Medio,No_siniestro,289980,49,10533.03,117211.04,0,1,0,0,0,0,1,0,0,0,0,0,0,0
Medio,No_siniestro,301741,24,54.66,0,0,0,0,0,0,0,0,0,0,0,0,0,0,0
Medio,No_siniestro,303163,60,9004.84,0,0,0,0,0,0,0,0,0,0,0,0,0,0,0
Medio,No_siniestro,303251,75,456.01,0,0,0,0,0,0,0,0,0,0,0,0,0,0,0
Medio,No_siniestro,305522,17,36.93,0,0,0,0,0,0,0,0,0,0,0,0,0,0,0
Medio,No_siniestro,305925,64,1491.08,0,0,0,0,0,0,0,0,0,0,0,0,0,0,0
Medio,No_siniestro,306226,46,745.68,0,0,0,0,0,0,0,0,0,0,0,0,0,0,0
Medio,No_siniestro,307702,75,205.05,0,0,0,0,0,0,0,0,0,0,0,0,0,0,0
Medio,No_siniestro,308158,27,1248.94,0,0,0,1,0,0,0,1,0,0,0,0,0,0,0
Medio,No_siniestro,308452,17,756.14,0,0,0,0,0,1,0,1,0,0,0,0,0,0,0
Medio,No_siniestro,309031,7,121.62,0,0,0,0,0,0,0,0,0,0,0,0,0,0,0
Medio,No_siniestro,309374,46,37299.52,0,0,0,0,0,0,0,0,0,0,0,0,0,0,0
Medio,No_siniestro,309984,8,4925.31,0,1,0,1,0,1,0,3,0,0,0,0,0,0,0
Medio,No_siniestro,310675,26,2338.66,0,0,0,0,0,0,0,0,0,0,0,0,0,0,0
Medio,No_siniestro,314503,17,4498.67,0,0,0,0,0,0,0,0,0,0,0,0,0,0,0
Medio,No_siniestro,345754,110,3516.92,0,0,0,0,0,0,0,0,0,0,0,0,0,0,0
Medio,No_siniestro,356767,40,1095.27,0,0,0,0,0,0,0,0,0,0,0,0,0,0,0
Medio,Si_siniestro,358415,12,9969.1,0,0,0,0,0,0,0,0,0,0,0,0,0,0,0
Medio,No_siniestro,359294,74,6162.88,0,0,0,0,0,0,0,0,0,0,0,0,0,0,0
Medio,No_siniestro,360973,11,0.08,0,0,0,0,0,0,0,0,0,0,0,0,0,0,0
Medio,No_siniestro,366178,52,2305.84,0,0,0,0,0,0,0,0,0,0,0,0,0,0,0
Medio,No_siniestro,371460,44,260.06,0,0,0,0,0,0,0,0,0,0,0,0,0,0,0
Medio,No_siniestro,372316,17,14.62,0,0,0,0,0,0,0,0,0,0,0,0,0,0,0
Medio,No_siniestro,373397,29,507.04,0,0,0,0,0,0,0,0,0,0,0,0,0,0,0
Medio,No_siniestro,374826,40,631.92,0,0,0,0,0,0,0,0,0,0,0,0,0,0,0
Medio,No_siniestro,375005,9,231.46,0,0,0,0,0,0,0,0,0,0,0,0,0,0,0
Medio,No_siniestro,379200,44,128.56,0,0,0,0,0,0,0,0,0,0,0,0,0,0,0
Medio,No_siniestro,410879,30,10068.69,0,0,0,0,0,0,0,0,0,0,0,0,0,0,0
Medio,No_siniestro,412730,44,348.89,0,0,0,0,0,0,0,0,0,0,0,0,0,0,0
Medio,No_siniestro,422378,49,3858.96,0,0,0,0,0,0,0,0,0,0,0,0,0,0,0
Medio,No_siniestro,432330,44,5.22,0,0,0,0,0,0,0,0,0,0,0,0,0,0,0
Medio,No_siniestro,435651,8,822.19,123695.47,0,0,0,0,0,0,0,0,0,0,0,0,0,0
Medio,No_siniestro,435746,17,5392.84,0,0,0,0,0,0,0,0,0,0,0,0,0,0,0
Medio,No_siniestro,437631,89,456.89,0,0,0,0,0,0,0,0,0,0,0,0,0,0,0
Medio,No_siniestro,438292,30,12972.55,0,0,0,0,0,0,0,0,0,0,0,0,0,0,0
Medio,No_siniestro,439092,41,471.75,0,0,0,0,0,0,0,0,0,0,0,0,0,0,0
Medio,No_siniestro,439098,39,161.22,0,0,0,0,0,0,0,0,0,0,0,0,0,0,0
Medio,No_siniestro,439378,51,267.34,0,0,0,0,0,0,0,0,0,0,0,0,0,0,0
Medio,No_siniestro,439602,40,11506.1,0,0,0,0,0,1,0,1,0,0,0,0,0,0,0
Medio,No_siniestro,439663,14,564.3,0,0,0,0,0,0,0,0,0,0,0,0,0,0,0
Medio,No_siniestro,440369,17,5615.5,0,0,0,0,0,0,0,0,0,0,0,0,0,0,0
Medio,No_siniestro,442010,44,6147.59,0,0,0,1,0,0,0,1,0,0,0,0,0,0,0
Medio,No_siniestro,445000,44,1883.64,66801.77,0,0,0,0,0,0,0,0,0,0,0,0,0,0
Medio,No_siniestro,445750,44,5010.21,0,0,0,0,0,0,0,0,0,0,0,0,0,0,0
Medio,No_siniestro,445880,44,283.47,0,0,0,0,0,0,0,0,0,0,0,0,0,0,0
Medio,Si_siniestro,446297,21,5581.35,0,0,0,0,0,0,0,0,0,0,0,0,0,0,0
Medio,No_siniestro,446617,19,2840.54,74854.62,0,0,0,0,0,0,0,0,0,0,0,0,0,0
Medio,No_siniestro,478395,10,410.7,0,0,0,0,0,0,0,0,0,0,0,0,0,0,0
Medio,No_siniestro,481594,31,2378.52,0,0,0,0,0,0,0,0,0,0,0,0,0,0,0
Medio,No_siniestro,487687,7,716.6,0,0,0,0,0,0,0,0,0,0,0,0,0,0,0
Medio,No_siniestro,490766,34,1681.51,0,0,0,0,0,0,0,0,0,0,0,0,0,0,0
Medio,No_siniestro,501095,44,5170.42,0,0,0,0,0,0,0,0,0,0,0,0,0,0,0
Medio,No_siniestro,501645,33,9815.52,0,0,0,0,0,0,0,0,0,0,0,0,0,0,0
Medio,No_siniestro,503081,25,24417.04,128122.62,0,0,0,0,0,0,0,0,0,0,0,0,0,0
Medio,No_siniestro,504071,39,9118.65,0,0,0,0,0,0,0,0,0,0,0,0,0,0,0
Medio,No_siniestro,504115,55,476.97,0,0,0,0,0,0,0,0,0,0,0,0,0,0,0
Medio,No_siniestro,504161,36,4238.87,0,0,0,0,0,0,0,0,0,0,0,0,0,0,0
Medio,No_siniestro,504597,70,25214.95,50221.75,0,0,0,0,0,0,0,0,0,0,0,0,0,0
Medio,No_siniestro,505042,81,1815.63,0,0,0,0,0,0,0,0,0,0,0,0,0,0,0
Medio,No_siniestro,506093,56,1893.3,0,0,0,0,0,0,0,0,0,0,0,0,0,0,0
Medio,No_siniestro,507223,28,166.44,0,0,0,0,0,0,0,0,0,0,0,0,0,0,0
Medio,No_siniestro,507475,9,40.02,0,0,0,0,0,0,0,0,0,0,0,0,0,0,0
Medio,No_siniestro,507730,40,387.96,0,0,0,0,0,0,0,0,0,0,0,0,0,0,0
Medio,No_siniestro,507791,12,9.59,0,0,0,0,0,0,0,0,0,0,0,0,0,0,0
Medio,No_siniestro,510298,19,804.96,0,0,0,0,1,0,0,1,0,0,0,0,0,0,0
Medio,No_siniestro,510336,14,255.28,0,0,0,0,0,0,0,0,0,0,0,0,0,0,0
Medio,No_siniestro,564281,19,2788.8,0,0,0,0,0,0,0,0,0,0,0,0,0,0,0
Medio,No_siniestro,564291,16,175.01,0,0,0,0,0,0,0,0,0,0,0,0,0,0,0
Medio,No_siniestro,567499,59,3884.3,0,0,0,0,0,0,0,0,0,0,0,0,0,0,0
Medio,No_siniestro,567580,40,394.67,0,0,0,0,0,0,0,0,0,0,0,0,0,0,0
Medio,No_siniestro,567942,11,1063.03,59936.51,0,0,0,0,0,0,0,0,0,0,0,0,0,0
Medio,No_siniestro,568186,55,557,0,0,0,0,0,0,0,0,0,0,0,0,0,0,0
Medio,No_siniestro,568518,6,1807.25,0,0,0,0,0,0,0,0,0,0,0,0,0,0,0
Medio,No_siniestro,570804,52,6567.04,45628.86,0,0,0,0,0,0,0,0,0,0,0,0,0,0
Medio,No_siniestro,571468,10,3477.1,0,0,0,0,0,0,0,0,0,0,0,0,0,0,0
Medio,No_siniestro,572107,63,1795.71,0,0,0,0,0,0,0,0,0,0,0,0,0,0,0
Medio,No_siniestro,572685,35,626.89,0,0,0,0,0,0,0,0,0,0,0,0,0,0,0
Medio,No_siniestro,572709,26,411.96,0,0,0,0,0,0,0,0,0,0,0,0,0,0,0
Medio,No_siniestro,573044,64,305.99,0,0,0,0,0,0,0,0,0,0,0,0,0,0,0
Medio,No_siniestro,574433,6,35.57,0,0,0,0,0,0,0,0,0,0,0,0,0,0,0
Medio,No_siniestro,576472,6,6589.59,0,0,0,0,0,0,0,0,0,0,0,0,0,0,0
Medio,No_siniestro,577773,15,388.07,46074.05,0,0,0,0,0,0,0,0,0,0,0,0,0,0
Medio,No_siniestro,614552,21,863.48,0,0,0,0,0,0,0,0,0,0,0,0,0,0,0
Medio,No_siniestro,624966,44,955.14,0,0,0,0,0,0,0,0,0,0,0,0,0,0,0
Medio,No_siniestro,636300,43,127.9,0,0,0,0,0,0,0,0,0,0,0,0,0,0,0
Medio,No_siniestro,637158,21,2739.95,0,0,0,0,0,0,0,0,0,0,0,0,0,0,0
Medio,No_siniestro,641399,6,219.08,0,0,0,0,0,0,0,0,0,0,0,0,0,0,0
Medio,No_siniestro,642620,43,5017.58,0,0,0,0,0,0,0,0,0,0,0,0,0,0,0
Medio,No_siniestro,646274,16,91.13,0,0,0,0,0,0,0,0,0,0,0,0,0,0,0
Medio,No_siniestro,647151,34,211.82,0,0,0,0,0,0,0,0,0,0,0,0,0,0,0
Medio,No_siniestro,647880,43,6887.76,0,0,0,0,0,0,0,0,0,0,0,0,0,0,0
Medio,No_siniestro,684457,41,213.84,0,0,0,0,0,0,0,0,0,0,0,0,0,0,0
Medio,No_siniestro,686521,22,1160.76,0,0,0,0,0,0,0,0,0,0,0,0,0,0,0
Medio,No_siniestro,691125,14,6514.95,43365.6,0,0,0,0,0,0,0,0,0,0,0,0,0,0
Medio,No_siniestro,696551,30,4097.74,0,0,0,0,0,0,0,0,0,0,0,0,0,0,0
Medio,No_siniestro,703925,84,13538.02,56712.64,0,0,0,0,0,0,0,0,0,0,0,0,0,0
Medio,No_siniestro,705630,43,8416.08,63000.17,0,0,0,0,0,0,0,0,0,0,0,0,0,0
Medio,No_siniestro,705995,12,6573.89,0,0,0,0,0,0,0,0,0,0,0,0,0,0,0
Medio,No_siniestro,706648,8,738.97,0,0,0,0,0,0,0,0,0,0,0,0,0,0,0
Medio,No_siniestro,706960,43,138.94,0,0,0,0,0,0,0,0,0,0,0,0,0,0,0
Medio,No_siniestro,707105,34,3851.3,0,0,0,0,0,0,0,0,0,0,0,0,0,0,0
Medio,No_siniestro,707821,28,336.06,0,0,1,0,0,0,0,1,0,0,0,0,0,0,0
Medio,No_siniestro,707871,59,5176.36,0,0,0,0,0,0,0,0,0,0,0,0,0,0,0
Medio,No_siniestro,708854,94,198.46,0,0,0,0,0,0,0,0,0,0,0,0,0,0,0
Medio,No_siniestro,709395,22,4550.27,0,0,0,0,0,0,0,0,0,0,0,0,0,0,0
Medio,No_siniestro,710993,36,6319.54,0,0,0,0,0,0,0,0,0,0,0,0,0,0,0
Medio,No_siniestro,711004,22,3294.09,0,0,0,0,0,0,0,0,0,0,0,0,0,0,0
Medio,No_siniestro,711247,12,1431.06,0,0,0,0,0,0,0,0,0,0,0,0,0,0,0
Medio,No_siniestro,712844,34,49.24,0,0,0,0,0,0,0,0,0,0,0,0,0,0,0
Medio,No_siniestro,713618,8,204.22,0,0,0,0,0,0,0,0,0,0,0,0,0,0,0
Medio,No_siniestro,715294,11,1259.33,0,0,0,0,0,0,0,0,0,0,0,0,0,0,0
Medio,No_siniestro,715441,28,2294.59,0,0,0,0,0,0,0,0,0,0,0,0,0,0,0
Medio,No_siniestro,716463,89,1601.19,0,0,0,0,0,0,0,0,0,0,0,0,0,0,0
Medio,No_siniestro,717841,6,775.98,0,0,0,0,0,0,0,0,0,0,0,0,0,0,0
Medio,Si_siniestro,717953,17,230.75,0,0,0,0,0,0,0,0,0,0,0,0,0,0,0
Medio,No_siniestro,718482,6,524.92,0,0,0,0,0,0,0,0,0,0,0,0,0,0,0
Medio,No_siniestro,751449,18,6.46,0,0,0,0,0,0,0,0,0,0,0,0,0,0,0
Medio,No_siniestro,760105,36,1020.36,0,0,0,0,0,0,0,0,0,0,0,0,0,0,0
Medio,No_siniestro,764626,43,613.21,0,0,0,0,0,0,0,0,0,0,0,0,0,0,0
Medio,No_siniestro,776883,59,10120.54,0,0,0,0,0,0,0,0,0,0,0,0,0,0,0
Medio,No_siniestro,778009,57,3929.23,0,0,0,0,0,0,0,0,0,0,0,0,0,0,0
Medio,No_siniestro,778047,41,1684.18,0,0,0,0,0,0,0,0,0,0,0,0,0,0,0
Medio,No_siniestro,778459,10,818.73,0,0,0,0,0,0,0,0,0,0,0,0,0,0,0
Medio,No_siniestro,779592,37,760.6,0,0,1,1,0,0,0,2,0,0,0,0,0,0,0
Medio,No_siniestro,779619,62,8052.8,0,0,0,0,0,0,0,0,0,0,0,0,0,0,0
Medio,No_siniestro,782428,7,146.93,0,0,0,0,0,0,0,0,0,0,0,0,0,0,0
Medio,No_siniestro,783384,15,11369.69,0,0,0,0,0,0,0,0,0,0,0,0,0,0,0
Medio,No_siniestro,783741,37,122.71,0,0,0,0,0,0,0,0,0,0,0,0,0,0,0
Medio,No_siniestro,783761,12,506.17,0,0,0,0,0,0,0,0,0,0,0,0,0,0,0
Medio,No_siniestro,783966,8,8665.26,0,0,0,0,0,0,0,0,0,0,0,0,0,0,0
Medio,No_siniestro,783991,6,155.77,0,0,0,0,0,0,0,0,0,0,0,0,0,0,0
Medio,No_siniestro,784793,20,332.23,0,0,0,0,0,0,0,0,0,0,0,0,0,0,0
Medio,No_siniestro,785222,18,963.03,0,0,0,0,0,0,0,0,0,0,0,0,0,0,0
Medio,No_siniestro,786143,6,73.7,0,0,0,0,0,0,0,0,0,0,0,0,0,0,0
Medio,No_siniestro,786256,7,246.65,0,0,0,0,0,0,0,0,0,0,0,0,0,0,0
Medio,No_siniestro,786356,22,216.4,0,0,0,0,0,0,0,0,0,0,0,0,0,0,0
Medio,No_siniestro,788435,33,2069.93,0,0,0,0,0,0,0,0,0,0,0,0,0,0,0
Medio,No_siniestro,39784,1,11.49,0,0,0,0,0,0,0,0,0,0,0,0,0,0,0
Medio,No_siniestro,50555,60,862.43,0,0,0,0,0,0,0,0,0,0,0,0,0,0,0
Medio,No_siniestro,120089,0,0,0,0,0,0,0,0,0,0,0,0,0,0,0,0,0
Medio,No_siniestro,121705,0,0,0,0,0,0,0,0,0,0,0,0,0,0,0,0,0
Medio,No_siniestro,124500,42,307.67,0,0,0,0,0,0,0,0,0,0,0,0,0,0,0
Medio,No_siniestro,180217,4,70.95,0,0,0,0,0,0,0,0,0,0,0,0,0,0,0
Medio,No_siniestro,181270,42,5554.89,0,0,0,0,0,0,0,0,0,0,0,0,0,0,0
Medio,No_siniestro,186088,4,1034.6,0,0,0,0,0,0,0,0,0,0,0,0,0,0,0
Medio,No_siniestro,240341,82,1891.61,0,0,0,0,0,0,0,0,0,0,0,0,0,0,0
Medio,No_siniestro,240944,43,10648.31,0,1,1,0,0,0,0,2,0,0,0,0,0,0,0
Medio,No_siniestro,246741,2,446.84,0,0,0,0,0,0,0,0,0,0,0,0,0,0,0
Medio,No_siniestro,249783,0,340.9,0,0,0,0,0,0,0,0,0,0,0,0,0,0,0
Medio,No_siniestro,251144,11,396.6,0,0,0,0,0,0,0,0,0,0,0,0,0,0,0
Medio,No_siniestro,315505,8,0,0,0,0,0,0,0,0,0,0,0,0,0,0,0,0
Medio,No_siniestro,315644,5,29.91,0,0,0,0,0,0,0,0,0,0,0,0,0,0,0
Medio,No_siniestro,356312,2,9907.57,0,0,0,0,0,0,0,0,0,0,0,0,0,0,0
Medio,No_siniestro,375698,5,41.16,0,0,0,0,0,0,0,0,0,0,0,0,0,0,0
Medio,No_siniestro,435884,79,0,0,0,0,0,0,0,0,0,0,0,0,0,0,0,0
Medio,No_siniestro,502174,9,11.76,0,0,0,0,0,0,0,0,0,0,0,0,0,0,0
Medio,No_siniestro,502364,81,0,0,0,0,0,0,0,0,0,0,0,0,0,0,0,0
Medio,No_siniestro,505646,9,3234.04,0,1,1,0,0,0,0,2,0,0,0,0,0,0,0
Medio,No_siniestro,505992,88,0,0,0,0,0,0,0,0,0,0,0,0,0,0,0,0
Medio,No_siniestro,509604,0,4496.88,0,0,0,0,0,0,0,0,0,0,0,0,0,0,0
Medio,No_siniestro,509920,42,425.98,0,0,0,0,0,0,0,0,0,0,0,0,0,0,0
Medio,No_siniestro,511249,1,19.38,0,0,0,0,0,0,0,0,0,0,0,0,0,0,0
Medio,No_siniestro,556461,14,0,0,0,0,0,0,0,0,0,0,0,0,0,0,0,0
Medio,No_siniestro,572063,2,0,71087.66,0,0,0,0,0,0,0,0,0,0,0,0,0,0
Medio,No_siniestro,574947,12,0,0,0,0,0,0,0,0,0,0,0,0,0,0,0,0
Medio,No_siniestro,575880,42,4.17,0,0,0,0,0,0,0,0,0,0,0,0,0,0,0
Medio,No_siniestro,639681,1,7.82,88372.13,0,0,0,0,0,0,0,0,0,0,0,0,0,0
Medio,No_siniestro,640818,36,0,0,0,0,0,0,0,0,0,0,0,0,0,0,0,0
Medio,No_siniestro,645426,6,458.83,0,0,0,0,0,0,0,0,0,0,0,0,0,0,0
Medio,No_siniestro,691564,2,22.98,0,0,0,0,0,0,0,0,0,0,0,0,0,0,0
Medio,No_siniestro,694394,74,0,0,0,0,0,0,0,0,0,0,0,0,0,0,0,0
Medio,No_siniestro,701711,0,12.77,0,0,0,0,0,0,0,0,0,0,0,0,0,0,0
Medio,No_siniestro,706011,15,0,0,0,0,0,0,0,0,0,0,0,0,0,0,0,0
Medio,No_siniestro,709476,2,6034.34,0,0,0,0,0,0,0,0,0,0,0,0,0,0,0
Medio,No_siniestro,715080,42,46.25,0,0,0,0,0,0,0,0,0,0,0,0,0,0,0
Medio,No_siniestro,720254,0,460.72,0,0,0,0,0,0,0,0,0,0,0,0,0,0,0
Medio,No_siniestro,765328,35,108.78,0,0,0,0,0,0,0,0,0,0,0,0,0,0,0
Medio,No_siniestro,773601,3,240.26,0,0,0,0,0,0,0,0,0,0,0,0,0,0,0
Medio,No_siniestro,783141,4,1100.2,41349.9,0,0,0,0,0,0,0,0,0,0,0,0,0,0
Medio,No_siniestro,784197,5,4078.44,55517.31,0,0,0,0,0,0,0,0,0,0,0,0,0,0
Medio,No_siniestro,790092,4,805.72,0,0,0,0,0,0,0,0,0,0,0,0,0,0,0
Bajo,No_siniestro,666,172,3517.07,0,0,0,0,0,0,0,0,0,0,0,0,0,0,0
Bajo,No_siniestro,696,136,1908.69,0,0,0,0,0,0,0,0,0,0,0,0,0,0,0
Bajo,No_siniestro,907,171,1895.19,0,0,0,0,0,0,0,0,0,0,0,0,0,0,0
Bajo,No_siniestro,5906,11,330.19,0,0,0,0,0,0,0,0,0,0,0,0,0,0,0
Bajo,No_siniestro,5993,34,479.58,0,0,0,0,0,0,0,0,0,0,0,0,0,0,0
Bajo,No_siniestro,7422,16,225.3,0,0,0,0,0,0,0,0,0,0,0,0,0,0,0
Bajo,No_siniestro,7609,11,591.01,0,0,0,0,0,0,0,0,0,0,0,0,0,0,0
Bajo,No_siniestro,8027,11,288.66,0,0,0,0,0,0,0,0,0,0,0,0,0,0,0
Bajo,No_siniestro,9455,95,3179.23,0,0,0,0,0,0,0,0,0,0,0,0,0,0,0
Bajo,No_siniestro,9546,6,310.21,0,0,0,0,0,0,0,0,0,0,0,0,0,0,0
Bajo,No_siniestro,9763,190,5263.07,0,0,0,0,0,0,0,0,0,0,0,0,0,0,0
Bajo,No_siniestro,11938,19,355.02,0,0,0,0,0,1,1,2,0,0,0,0,0,0,0
Bajo,No_siniestro,12416,8,545.33,0,0,0,0,0,0,0,0,0,0,0,0,0,0,0
Bajo,No_siniestro,13353,6,826.22,0,0,0,0,0,0,0,0,0,0,0,0,0,0,0
Bajo,No_siniestro,13982,35,4253.18,0,0,0,0,0,0,0,0,0,0,0,0,0,0,0
Bajo,No_siniestro,14004,7,650.02,0,0,0,0,0,0,0,0,0,0,0,0,0,0,0
Bajo,No_siniestro,14920,39,756.81,0,0,0,0,0,0,0,0,0,0,0,0,0,0,0
Bajo,No_siniestro,15537,7,600.35,0,0,0,0,0,0,0,0,0,0,0,0,0,0,0
Bajo,No_siniestro,16066,20,1303.75,0,0,0,0,0,0,0,0,0,0,0,0,0,0,0
Bajo,No_siniestro,17795,8,2561.98,0,0,0,0,0,0,0,0,0,0,0,0,0,0,0
Bajo,No_siniestro,17943,8,660.97,0,0,0,0,0,0,0,0,0,0,0,0,0,0,0
Bajo,No_siniestro,18293,20,1317.4,0,0,0,0,0,0,0,0,0,0,0,0,0,0,0
Bajo,Si_siniestro,20023,79,29.97,0,0,1,0,0,0,0,1,0,0,0,0,0,0,0
Bajo,No_siniestro,20116,126,1356.23,0,0,0,0,0,0,0,0,0,0,0,0,0,0,0
Bajo,No_siniestro,20186,182,1743.45,0,0,0,0,0,0,0,0,0,0,0,0,0,0,0
Bajo,No_siniestro,21678,106,68.73,0,0,0,0,0,0,0,0,0,0,0,0,0,0,0
Bajo,No_siniestro,22954,34,1606.87,0,0,0,0,0,0,0,0,0,0,0,0,0,0,0
Bajo,No_siniestro,23145,24,173.41,0,0,0,0,0,0,0,0,0,0,0,0,0,0,0
Bajo,No_siniestro,23303,41,350.8,0,0,0,0,0,0,0,0,0,0,0,0,0,0,0
Bajo,Si_siniestro,24187,7,765.53,0,1,1,1,1,1,1,6,0,0,0,0,0,0,0
Bajo,No_siniestro,25230,39,2025.88,0,0,0,0,0,0,0,0,0,0,0,0,0,0,0
Bajo,No_siniestro,25952,106,2974.09,0,0,0,0,0,0,0,0,0,0,0,0,0,0,0
Bajo,No_siniestro,30429,107,58.11,0,0,0,0,0,0,0,0,0,0,0,0,0,0,0
Bajo,No_siniestro,30430,39,4158.08,0,0,0,0,0,0,0,0,0,0,0,0,0,0,0
Bajo,No_siniestro,31948,8,541.82,0,0,0,0,0,1,0,1,0,0,0,0,0,0,0
Bajo,Si_siniestro,32410,39,3619.53,0,0,0,0,0,0,0,0,0,0,0,0,0,0,0
Bajo,No_siniestro,32455,23,2636.32,0,0,0,0,0,0,0,0,0,0,0,0,0,0,0
Bajo,No_siniestro,33923,10,1167.75,0,1,1,1,1,0,1,5,0,0,0,0,0,0,0
Bajo,No_siniestro,34177,7,1246.62,0,0,0,0,0,0,0,0,0,0,0,0,0,0,0
Bajo,No_siniestro,34226,103,475.08,0,0,0,0,0,0,0,0,0,0,0,0,0,0,0
Bajo,No_siniestro,37646,33,6,0,0,0,0,1,0,0,1,0,0,0,0,0,0,0
Bajo,No_siniestro,38245,138,481.77,0,0,0,0,0,0,0,0,0,0,0,0,0,0,0
Bajo,No_siniestro,38511,23,1676.97,14897.48,0,0,0,0,0,0,0,0,0,0,0,0,0,0
Bajo,No_siniestro,39286,40,688.03,0,0,0,0,0,0,0,0,0,0,0,0,0,0,0
Bajo,No_siniestro,39366,22,930.39,0,0,0,0,0,0,0,0,0,0,0,0,0,0,0
Bajo,No_siniestro,39499,10,2386.62,0,0,0,0,0,0,0,0,0,0,0,0,0,0,0
Bajo,No_siniestro,39938,7,373.04,0,0,0,0,0,0,0,0,0,0,0,0,0,0,0
Bajo,No_siniestro,40024,58,1371.32,0,0,0,0,0,0,0,0,0,0,0,0,0,0,0
Bajo,No_siniestro,40794,9,1350.54,0,0,1,0,0,0,0,1,0,0,0,0,0,0,0
Bajo,No_siniestro,40816,8,1516.71,0,0,0,0,0,0,0,0,0,0,0,0,0,0,0
Bajo,No_siniestro,40971,19,604.51,0,0,0,0,0,0,0,0,0,0,0,0,0,0,0
Bajo,No_siniestro,41273,24,470.95,0,0,0,0,0,0,0,0,0,0,0,0,0,0,0
Bajo,No_siniestro,41888,14,724.19,0,1,1,1,0,0,0,3,0,0,0,0,0,0,0
Bajo,No_siniestro,43697,51,833.11,0,0,0,0,0,0,0,0,0,0,0,0,0,0,0
Bajo,No_siniestro,44185,47,144.27,0,0,0,0,0,0,0,0,0,0,0,0,0,0,0
Bajo,No_siniestro,44780,39,759.08,0,0,0,0,0,0,0,0,0,0,0,0,0,0,0
Bajo,No_siniestro,45269,6,357.35,0,0,0,0,0,0,0,0,0,0,0,0,0,0,0
Bajo,No_siniestro,46585,21,954.33,0,0,0,0,0,0,0,0,0,0,0,0,0,0,0
Bajo,No_siniestro,47516,12,267.5,0,0,0,0,0,0,0,0,0,0,0,0,0,0,0
Bajo,No_siniestro,48307,11,332.75,0,0,0,0,0,0,0,0,0,0,0,0,0,0,0
Bajo,No_siniestro,48849,8,3661.65,0,0,0,0,0,0,0,0,0,0,0,0,0,0,0
Bajo,No_siniestro,49938,11,707.29,0,0,0,0,0,0,0,0,0,0,0,0,0,0,0
Bajo,No_siniestro,49949,48,157.27,0,0,0,0,0,0,0,0,0,0,0,0,0,0,0
Bajo,No_siniestro,50198,11,104.07,0,0,1,0,0,0,0,1,0,0,0,0,0,0,0
Bajo,No_siniestro,50583,17,160.91,0,0,0,0,0,0,0,0,0,0,0,0,0,0,0
Bajo,No_siniestro,50853,36,831.4,0,0,0,0,0,0,0,0,0,0,0,0,0,0,0
Bajo,No_siniestro,51095,87,57.82,0,0,0,0,0,0,0,0,0,0,0,0,0,0,0
Bajo,No_siniestro,52942,41,0.57,0,0,0,0,0,0,0,0,0,0,0,0,0,0,0
Bajo,No_siniestro,53193,22,258.36,0,0,0,0,0,0,0,0,0,0,0,0,0,0,0
Bajo,No_siniestro,53682,68,158.6,0,0,0,0,0,0,0,0,0,0,0,0,0,0,0
Bajo,No_siniestro,54732,7,121.38,0,0,0,0,0,0,0,0,0,0,0,0,0,0,0
Bajo,Si_siniestro,55446,10,702.96,0,0,1,1,0,0,0,2,0,0,0,0,0,0,0
Bajo,No_siniestro,57300,39,630.3,0,0,0,0,0,0,0,0,0,0,0,0,0,0,0
Bajo,No_siniestro,59449,51,912.8,0,0,0,0,0,0,0,0,0,0,0,0,0,0,0
Bajo,No_siniestro,62099,15,153.2,0,0,0,0,0,0,0,0,0,0,0,0,0,0,0
Bajo,No_siniestro,62130,39,948.6,0,0,0,0,0,0,0,0,0,0,0,0,0,0,0
Bajo,No_siniestro,62776,133,1577.81,0,0,0,0,0,0,0,0,0,0,0,0,0,0,0
Bajo,No_siniestro,62923,21,6075.68,0,0,0,0,0,0,0,0,0,0,0,0,0,0,0
Bajo,No_siniestro,63364,58,3282.86,0,0,0,0,0,0,0,0,0,0,0,0,0,0,0
Bajo,No_siniestro,63966,59,531.89,0,0,0,0,0,0,0,0,0,0,0,0,0,0,0
Bajo,No_siniestro,64572,78,23.4,0,0,0,0,0,0,0,0,0,0,0,0,0,0,0
Bajo,No_siniestro,66787,26,21.78,0,0,0,0,0,0,0,0,0,0,0,0,0,0,0
Bajo,No_siniestro,66853,24,1099.84,17326.46,0,0,0,0,0,0,0,0,0,0,0,0,0,0
Bajo,No_siniestro,68479,62,124.41,0,0,0,0,0,0,0,0,0,0,0,0,0,0,0
Bajo,No_siniestro,71365,141,139.98,0,0,0,0,0,0,0,0,0,0,0,0,0,0,0
Bajo,No_siniestro,71548,17,0.14,0,0,0,0,0,0,0,0,0,0,0,0,0,0,0
Bajo,Si_siniestro,72185,6,842.33,0,0,0,0,0,0,0,0,0,0,0,0,0,0,0
Bajo,No_siniestro,73627,7,308.79,0,0,0,0,0,0,0,0,0,0,0,0,0,0,0
Bajo,No_siniestro,75501,44,398.02,0,0,0,0,0,0,0,0,0,0,0,0,0,0,0
Bajo,No_siniestro,75737,87,41.89,0,0,0,0,0,0,0,0,0,0,0,0,0,0,0
Bajo,No_siniestro,76073,9,110.42,0,0,0,0,0,0,0,0,0,0,0,0,0,0,0
Bajo,No_siniestro,76166,47,3416.24,0,0,0,0,0,0,0,0,0,0,0,0,0,0,0
Bajo,No_siniestro,76978,24,729.61,0,0,0,0,0,0,0,0,0,0,0,0,0,0,0
Bajo,No_siniestro,78329,11,1968.4,0,0,0,0,0,0,0,0,0,0,0,0,0,0,0
Bajo,No_siniestro,78357,129,742.25,0,0,0,0,0,0,0,0,0,0,0,0,0,0,0
Bajo,No_siniestro,78387,7,885.56,0,0,0,0,0,0,0,0,0,0,0,0,0,0,0
Bajo,No_siniestro,79581,8,713.4,0,0,0,0,0,0,0,0,0,0,0,0,0,0,0
Bajo,No_siniestro,79980,39,389.22,0,0,0,0,0,0,0,0,0,0,0,0,0,0,0
Bajo,No_siniestro,81940,39,362.91,0,0,0,0,0,0,0,0,0,0,0,0,0,0,0
Bajo,No_siniestro,83271,169,871.52,0,0,0,0,0,0,0,0,0,0,0,0,0,0,0
Bajo,No_siniestro,83624,7,288.76,0,0,0,0,0,0,0,0,0,0,0,0,0,0,0
Bajo,No_siniestro,87592,35,1953.8,0,0,0,0,0,0,0,0,0,0,0,0,0,0,0
Bajo,No_siniestro,88529,10,1777.38,0,0,0,0,0,0,0,0,0,0,0,0,0,0,0
Bajo,No_siniestro,89570,39,816.76,0,0,0,0,0,0,0,0,0,0,0,0,0,0,0
Bajo,No_siniestro,90527,16,462.64,0,0,0,0,0,0,0,0,0,0,0,0,0,0,0
Bajo,No_siniestro,91074,135,1072.38,0,0,0,0,0,0,0,0,0,0,0,0,0,0,0
Bajo,No_siniestro,91528,8,864.63,0,0,0,0,0,0,0,0,0,0,0,0,0,0,0
Bajo,No_siniestro,91580,39,12.36,0,0,0,0,0,0,0,0,0,0,0,0,0,0,0
Bajo,No_siniestro,91668,56,750.69,0,0,0,0,0,0,0,0,0,0,0,0,0,0,0
Bajo,No_siniestro,93784,60,1583.27,0,0,0,0,0,0,0,0,0,0,0,0,0,0,0
Bajo,No_siniestro,95450,39,594.06,0,0,0,0,0,0,0,0,0,0,0,0,0,0,0
Bajo,No_siniestro,95474,116,71.37,0,0,0,0,0,0,0,0,0,0,0,0,0,0,0
Bajo,No_siniestro,96817,9,1308.97,0,0,0,0,0,0,0,0,0,0,0,0,0,0,0
Bajo,No_siniestro,98825,13,3592.83,0,0,0,0,0,0,0,0,0,0,0,0,0,0,0
Bajo,No_siniestro,99522,34,589.92,0,0,0,0,0,0,0,0,0,0,0,0,0,0,0
Bajo,No_siniestro,100416,13,245.94,0,0,0,0,0,0,0,0,0,0,0,0,0,0,0
Bajo,No_siniestro,102007,77,1651.21,0,0,0,0,0,0,0,0,0,0,0,0,0,0,0
Bajo,No_siniestro,102451,24,1260.8,0,1,1,1,1,0,0,4,0,0,0,0,0,0,0
Bajo,No_siniestro,102566,81,876.1,0,0,0,0,0,0,0,0,0,0,0,0,0,0,0
Bajo,No_siniestro,103022,14,2176.15,0,0,0,0,0,0,0,0,0,0,0,0,0,0,0
Bajo,No_siniestro,104347,6,880.79,0,0,0,0,0,0,0,0,0,0,0,0,0,0,0
Bajo,No_siniestro,105366,100,979.09,0,0,0,0,0,0,0,0,0,0,0,0,0,0,0
Bajo,No_siniestro,105954,34,660.31,0,0,0,0,0,0,0,0,0,0,0,0,0,0,0
Bajo,No_siniestro,106610,39,65.81,0,0,0,0,0,0,0,0,0,0,0,0,0,0,0
Bajo,No_siniestro,111373,13,775.88,0,0,1,0,1,1,0,3,0,0,0,0,0,0,0
Bajo,No_siniestro,111768,35,932.07,0,2,1,1,1,1,1,7,0,0,0,0,0,0,0
Bajo,No_siniestro,112386,12,917.95,0,0,0,0,0,0,0,0,0,0,0,0,0,0,0
Bajo,No_siniestro,112568,50,330.91,0,0,0,0,0,0,0,0,0,0,0,0,0,0,0
Bajo,No_siniestro,112751,6,810.93,0,0,0,0,0,0,0,0,0,0,0,0,0,0,0
Bajo,Si_siniestro,112784,12,1362.24,0,0,0,0,0,0,0,0,0,0,0,0,0,0,0
Bajo,No_siniestro,112874,46,216.19,0,0,0,0,0,0,0,0,0,0,0,0,0,0,0
Bajo,No_siniestro,112970,39,1045.88,0,0,0,0,0,0,0,0,0,0,0,0,0,0,0
Bajo,No_siniestro,114421,69,1478.47,0,0,0,0,0,0,0,0,0,0,0,0,0,0,0
Bajo,No_siniestro,116352,23,1672.1,0,0,0,0,0,0,0,0,0,0,0,0,0,0,0
Bajo,No_siniestro,116441,9,770.36,0,0,0,0,0,0,0,0,0,0,0,0,0,0,0
Bajo,No_siniestro,118079,9,2680.47,0,0,0,0,0,0,0,0,0,0,0,0,0,0,0
Bajo,No_siniestro,118895,7,1306.12,0,0,0,0,0,0,0,0,0,0,0,0,0,0,0
Bajo,No_siniestro,119489,9,358.35,0,0,0,0,0,1,0,1,0,0,0,0,0,0,0
Bajo,No_siniestro,119815,8,2044.19,0,0,0,0,0,0,0,0,0,0,0,0,0,0,0
Bajo,No_siniestro,120130,39,80.07,0,0,0,0,0,0,0,0,0,0,0,0,0,0,0
Bajo,No_siniestro,121416,17,1159.95,0,0,0,0,0,0,0,0,0,0,0,0,0,0,0
Bajo,No_siniestro,122166,8,309.59,0,0,0,0,0,0,0,0,0,0,0,0,0,0,0
Bajo,No_siniestro,122996,22,1327.72,0,0,0,0,0,0,0,0,0,0,0,0,0,0,0
Bajo,No_siniestro,123407,84,1110.13,0,0,0,0,0,0,0,0,0,0,0,0,0,0,0
Bajo,No_siniestro,123876,12,1138.95,0,0,0,0,0,0,0,0,0,0,0,0,0,0,0
Bajo,No_siniestro,124047,13,1356.32,0,0,0,0,0,0,0,0,0,0,0,0,0,0,0
Bajo,No_siniestro,126730,39,921.37,0,1,0,0,0,0,0,1,0,0,0,0,0,0,0
Bajo,No_siniestro,127700,39,477.71,0,0,0,0,0,0,0,0,0,0,0,0,0,0,0
Bajo,No_siniestro,129258,38,0.09,0,0,0,0,0,0,0,0,0,0,0,0,0,0,0
Bajo,No_siniestro,131044,46,1517.87,0,0,0,0,0,0,0,0,0,0,0,0,0,0,0
Bajo,No_siniestro,132727,12,2575.95,0,0,0,0,0,0,0,0,0,0,0,0,0,0,0
Bajo,No_siniestro,132991,110,2431.08,0,1,0,0,1,0,0,2,0,0,0,0,0,0,0
Bajo,No_siniestro,133398,13,434.03,0,0,0,0,0,0,0,0,0,0,0,0,0,0,0
Bajo,No_siniestro,133806,16,3487.75,0,0,0,0,0,0,0,0,0,0,0,0,0,0,0
Bajo,No_siniestro,134005,45,347.96,0,0,0,0,0,0,0,0,0,0,0,0,0,0,0
Bajo,No_siniestro,134239,11,350.84,0,0,0,0,0,0,0,0,0,0,0,0,0,0,0
Bajo,No_siniestro,134609,93,242.79,0,0,0,0,0,0,0,0,0,0,0,0,0,0,0
Bajo,No_siniestro,134752,13,1901.89,0,0,0,0,0,0,0,0,0,0,0,0,0,0,0
Bajo,No_siniestro,137563,14,278.37,0,0,0,0,0,0,0,0,0,0,0,0,0,0,0
Bajo,Si_siniestro,140203,17,85.46,0,0,0,1,0,0,0,1,0,0,0,0,0,0,0
Bajo,No_siniestro,142153,21,1657.1,0,0,0,0,0,0,0,0,0,0,0,0,0,0,0
Bajo,No_siniestro,143034,25,36.85,0,0,0,0,0,0,0,0,0,0,0,0,0,0,0
Bajo,No_siniestro,143604,60,30.72,0,0,0,0,0,0,0,0,0,0,0,0,0,0,0
Bajo,No_siniestro,143659,12,1326.18,0,0,0,0,0,0,0,0,0,0,0,0,0,0,0
Bajo,No_siniestro,144237,117,5246.85,0,0,0,0,0,0,0,0,0,0,0,0,0,0,0
Bajo,No_siniestro,144501,19,572.02,0,0,0,0,0,0,0,0,0,0,0,0,0,0,0
Bajo,No_siniestro,144666,7,2950.41,0,0,0,0,0,0,0,0,0,0,0,0,0,0,0
Bajo,Si_siniestro,144994,21,2759.94,0,0,0,0,0,0,0,0,0,0,0,0,0,0,0
Bajo,No_siniestro,146394,9,2343.18,0,0,0,0,0,0,0,0,0,0,0,0,0,0,0
Bajo,No_siniestro,149068,27,4784.77,0,0,0,0,0,0,0,0,0,0,0,0,0,0,0
Bajo,No_siniestro,149254,50,1130.73,0,0,0,0,0,0,0,0,0,0,0,0,0,0,0
Bajo,No_siniestro,149396,59,1352.61,0,0,0,0,0,0,0,0,0,0,0,0,0,0,0
Bajo,No_siniestro,150207,32,91.87,10088.58,0,0,0,0,0,0,0,0,0,0,0,0,0,0
Bajo,No_siniestro,151004,149,229.9,0,0,0,0,0,0,0,0,0,0,0,0,0,0,0
Bajo,No_siniestro,152800,39,859.94,0,0,0,0,0,0,0,0,0,0,0,0,0,0,0
Bajo,No_siniestro,153346,13,1827.39,0,0,0,0,0,0,0,0,0,0,0,0,0,0,0
Bajo,No_siniestro,154556,94,52.95,0,0,0,0,0,0,0,0,0,0,0,0,0,0,0
Bajo,No_siniestro,154719,8,19.21,0,0,0,0,0,0,0,0,0,0,0,0,0,0,0
Bajo,No_siniestro,158628,14,1632.97,0,0,0,0,0,0,0,0,0,0,0,0,0,0,0
Bajo,No_siniestro,158691,15,324.76,0,0,0,0,0,0,0,0,0,0,0,0,0,0,0
Bajo,No_siniestro,158952,23,688.58,0,2,1,0,1,0,1,5,0,0,0,0,0,0,0
Bajo,No_siniestro,159892,23,60.44,0,0,0,0,0,0,0,0,0,0,0,0,0,0,0
Bajo,No_siniestro,162115,14,1215.97,0,0,0,0,0,0,0,0,0,0,0,0,0,0,0
Bajo,No_siniestro,163172,14,869.02,0,0,0,0,0,0,0,0,0,0,0,0,0,0,0
Bajo,No_siniestro,163221,16,957.67,0,0,0,0,0,0,0,0,0,0,0,0,0,0,0
Bajo,No_siniestro,163755,71,262.36,0,0,0,0,0,0,0,0,0,0,0,0,0,0,0
Bajo,No_siniestro,164898,57,737.52,0,0,0,0,0,0,0,0,0,0,0,0,0,0,0
Bajo,No_siniestro,166315,76,469.69,0,0,0,0,0,0,0,0,0,0,0,0,0,0,0
Bajo,No_siniestro,167522,106,623.97,0,0,0,0,0,0,0,0,0,0,0,0,0,0,0
Bajo,No_siniestro,168326,13,807.3,0,0,0,0,0,0,0,0,0,0,0,0,0,0,0
Bajo,No_siniestro,168616,8,681.68,0,0,0,0,0,0,0,0,0,0,0,0,0,0,0
Bajo,No_siniestro,168692,10,1175.58,0,0,0,0,0,0,0,0,0,0,0,0,0,0,0
Bajo,No_siniestro,168801,14,2166.23,0,0,0,0,0,0,0,0,0,0,0,0,0,0,0
Bajo,No_siniestro,170193,78,687.92,0,0,0,0,0,0,0,0,0,0,0,0,0,0,0
Bajo,No_siniestro,170339,60,1852.44,0,0,0,1,0,0,0,1,0,0,0,0,0,0,0
Bajo,No_siniestro,170348,59,1093.08,0,0,0,0,0,0,0,0,0,0,0,0,0,0,0
Bajo,No_siniestro,170524,7,636.34,0,0,0,0,0,0,0,0,0,0,0,0,0,0,0
Bajo,Si_siniestro,172123,14,929.27,0,1,0,0,0,0,0,1,0,0,0,0,0,0,0
Bajo,No_siniestro,172970,49,1155.33,0,0,0,0,0,0,0,0,0,0,0,0,0,0,0
Bajo,No_siniestro,173705,26,2904.47,0,0,0,0,0,0,0,0,0,0,0,0,0,0,0
Bajo,Si_siniestro,174110,49,181.45,0,0,0,0,0,0,0,0,0,0,0,0,0,0,0
Bajo,No_siniestro,174618,10,3349.55,0,0,0,0,0,0,0,0,0,0,0,0,0,0,0
Bajo,No_siniestro,174795,133,2303.42,0,0,0,0,0,0,0,0,0,0,0,0,0,0,0
Bajo,No_siniestro,175077,10,1996.34,0,0,0,0,0,0,0,0,0,0,0,0,0,0,0
Bajo,No_siniestro,175539,6,1058.87,0,1,0,0,0,0,0,1,0,0,0,0,0,0,0
Bajo,No_siniestro,175587,56,1666.65,0,0,1,0,0,0,0,1,0,0,0,0,0,0,0
Bajo,No_siniestro,177933,61,488.33,0,0,0,0,0,0,0,0,0,0,0,0,0,0,0
Bajo,No_siniestro,178854,12,1119.88,0,0,0,0,0,0,0,0,0,0,0,0,0,0,0
Bajo,Si_siniestro,178945,14,357.85,0,1,0,0,2,1,0,4,0,0,0,0,0,0,0
Bajo,No_siniestro,179697,34,1572.51,0,0,0,0,0,0,0,0,0,0,0,0,0,0,0
Bajo,No_siniestro,179943,57,899.16,0,0,0,0,0,0,0,0,0,0,0,0,0,0,0
Bajo,No_siniestro,180078,24,639.95,0,0,0,0,0,0,0,0,0,0,0,0,0,0,0
Bajo,No_siniestro,181048,7,1099.66,0,0,0,0,0,0,0,0,0,0,0,0,0,0,0
Bajo,No_siniestro,181761,6,1320.13,0,0,0,0,0,0,0,0,0,0,0,0,0,0,0
Bajo,No_siniestro,184242,23,150.47,0,0,0,0,0,0,0,0,0,0,0,0,0,0,0
Bajo,No_siniestro,184290,49,0.21,0,0,0,0,0,0,0,0,0,0,0,0,0,0,0
Bajo,Si_siniestro,184659,12,609.49,0,0,0,0,0,0,0,0,0,0,0,0,0,0,0
Bajo,No_siniestro,184932,12,336.54,0,0,0,0,0,0,0,0,0,0,0,0,0,0,0
Bajo,No_siniestro,186737,24,165.21,0,0,0,0,0,0,0,0,0,0,0,0,0,0,0
Bajo,No_siniestro,187620,49,416.24,0,0,0,0,0,0,0,0,0,0,0,0,0,0,0
Bajo,No_siniestro,188023,22,1656.74,0,0,0,0,0,0,0,0,0,0,0,0,0,0,0
Bajo,No_siniestro,188839,93,30.45,0,0,0,0,0,0,0,0,0,0,0,0,0,0,0
Bajo,No_siniestro,189104,83,2164.03,0,0,0,0,0,0,0,0,0,0,0,0,0,0,0
Bajo,No_siniestro,189209,160,323.44,0,0,0,0,0,0,0,0,0,0,0,0,0,0,0
Bajo,No_siniestro,189718,33,1957.35,0,0,0,0,0,0,1,1,0,0,0,0,0,0,0
Bajo,No_siniestro,189953,47,1408.32,0,0,0,0,0,0,0,0,0,0,0,0,0,0,0
Bajo,No_siniestro,190864,151,3469.52,0,0,0,0,0,0,0,0,0,0,0,0,0,0,0
Bajo,No_siniestro,193620,49,218.68,0,0,0,0,0,0,0,0,0,0,0,0,0,0,0
Bajo,No_siniestro,195728,12,975.93,0,0,0,0,0,0,0,0,0,0,0,0,0,0,0
Bajo,No_siniestro,196869,28,0.01,0,0,0,0,0,0,0,0,0,0,0,0,0,0,0
Bajo,Si_siniestro,197376,16,1574.13,0,1,1,0,0,0,1,3,0,0,0,0,0,0,0
Bajo,No_siniestro,198891,49,512.85,0,0,0,0,0,0,0,0,0,0,0,0,0,0,0
Bajo,No_siniestro,199261,48,946.14,0,0,0,0,0,1,0,1,0,0,0,0,0,0,0
Bajo,No_siniestro,200436,84,1612.4,0,0,0,0,0,0,0,0,0,0,0,0,0,0,0
Bajo,No_siniestro,201113,18,81.32,0,0,0,0,0,0,0,0,0,0,0,0,0,0,0
Bajo,No_siniestro,201844,8,3653.15,0,0,0,0,0,0,0,0,0,0,0,0,0,0,0
Bajo,No_siniestro,205176,194,0.05,0,0,0,0,0,0,0,0,0,0,0,0,0,0,0
Bajo,No_siniestro,205389,24,2967.43,0,1,0,0,0,0,0,1,0,0,0,0,0,0,0
Bajo,No_siniestro,205929,55,4.95,0,0,0,0,0,0,0,0,0,0,0,0,0,0,0
Bajo,No_siniestro,206789,56,4821.84,0,0,0,0,0,0,0,0,0,0,0,0,0,0,0
Bajo,No_siniestro,213219,87,500.79,0,0,0,0,0,0,0,0,0,0,0,0,0,0,0
Bajo,No_siniestro,215721,6,977.48,0,0,0,0,0,0,0,0,0,0,0,0,0,0,0
Bajo,No_siniestro,216132,13,533.19,0,0,0,0,0,0,0,0,0,0,0,0,0,0,0
Bajo,Si_siniestro,217559,63,2841.32,0,1,1,1,0,0,1,4,0,0,0,0,0,0,0
Bajo,No_siniestro,218214,15,712.55,0,0,0,0,0,0,0,0,0,0,0,0,0,0,0
Bajo,No_siniestro,218573,10,592.08,0,0,0,0,0,0,0,0,0,0,0,0,0,0,0
Bajo,No_siniestro,220609,91,73.32,0,0,0,0,0,0,0,0,0,0,0,0,0,0,0
Bajo,No_siniestro,220766,16,614.61,0,0,0,0,0,0,0,0,0,0,0,0,0,0,0
Bajo,No_siniestro,221573,7,1640.65,0,0,0,0,0,0,0,0,0,0,0,0,0,0,0
Bajo,No_siniestro,222691,44,851.24,0,0,0,0,0,0,0,0,0,0,0,0,0,0,0
Bajo,No_siniestro,224321,7,2570.53,0,0,0,0,0,0,0,0,0,0,0,0,0,0,0
Bajo,No_siniestro,225780,49,1434.35,0,0,0,0,0,0,0,0,0,0,0,0,0,0,0
Bajo,No_siniestro,226090,49,2092.93,0,0,0,0,0,0,0,0,0,0,0,0,0,0,0
Bajo,No_siniestro,226616,38,212.24,0,0,0,0,0,0,0,0,0,0,0,0,0,0,0
Bajo,No_siniestro,229790,49,345.71,0,0,0,0,0,0,0,0,0,0,0,0,0,0,0
Bajo,No_siniestro,230003,19,649.68,0,0,0,0,0,0,0,0,0,0,0,0,0,0,0
Bajo,No_siniestro,230878,48,798.62,0,0,0,0,0,0,0,0,0,0,0,0,0,0,0
Bajo,No_siniestro,232349,74,83.41,0,0,0,0,0,0,0,0,0,0,0,0,0,0,0
Bajo,No_siniestro,233542,10,1306.09,0,0,0,0,0,0,0,0,0,0,0,0,0,0,0
Bajo,No_siniestro,233757,6,854.77,0,0,0,0,0,0,0,0,0,0,0,0,0,0,0
Bajo,No_siniestro,233840,49,16.42,0,1,0,0,0,0,1,2,0,0,0,0,0,0,0
Bajo,Si_siniestro,234909,25,4195.69,0,0,0,0,0,0,0,0,0,0,0,0,0,0,0
Bajo,No_siniestro,235651,24,63.97,0,0,0,0,0,0,0,0,0,0,0,0,0,0,0
Bajo,No_siniestro,237259,41,106.92,0,0,0,0,0,0,0,0,0,0,0,0,0,0,0
Bajo,No_siniestro,238940,49,41.92,0,0,0,0,0,0,0,0,0,0,0,0,0,0,0
Bajo,No_siniestro,239899,27,1359.01,0,0,0,0,0,0,0,0,0,0,0,0,0,0,0
Bajo,No_siniestro,240359,30,1548.63,0,0,0,0,0,0,0,0,0,0,0,0,0,0,0
Bajo,No_siniestro,240772,43,702.65,0,0,0,0,0,0,0,0,0,0,0,0,0,0,0
Bajo,No_siniestro,242893,10,22.3,0,0,0,0,0,0,0,0,0,0,0,0,0,0,0
Bajo,No_siniestro,243540,49,254.51,0,0,0,0,0,0,0,0,0,0,0,0,0,0,0
Bajo,No_siniestro,244208,49,269.74,0,0,0,0,0,0,0,0,0,0,0,0,0,0,0
Bajo,Si_siniestro,244898,12,1198.64,0,0,0,0,0,0,0,0,0,0,0,0,0,0,0
Bajo,No_siniestro,246592,15,733.03,0,0,0,0,0,0,0,0,0,0,0,0,0,0,0
Bajo,No_siniestro,246921,60,1065.22,0,0,1,1,0,0,0,2,0,0,0,0,0,0,0
Bajo,No_siniestro,247693,11,1974.3,0,0,0,0,0,0,0,0,0,0,0,0,0,0,0
Bajo,No_siniestro,248982,9,16.96,0,1,0,0,0,0,0,1,0,0,0,0,0,0,0
Bajo,No_siniestro,249749,31,350.57,0,0,0,0,0,0,0,0,0,0,0,0,0,0,0
Bajo,No_siniestro,251334,8,1417.5,0,0,0,0,0,0,0,0,0,0,0,0,0,0,0
Bajo,No_siniestro,252228,89,521.45,0,0,0,0,0,0,0,0,0,0,0,0,0,0,0
Bajo,No_siniestro,252426,17,333.35,0,0,0,0,0,0,0,0,0,0,0,0,0,0,0
Bajo,No_siniestro,254342,11,607.44,0,0,0,0,0,0,0,0,0,0,0,0,0,0,0
Bajo,No_siniestro,254729,24,866.14,0,0,0,0,0,0,0,0,0,0,0,0,0,0,0
Bajo,No_siniestro,255955,14,1521.97,0,0,0,0,0,1,0,1,0,0,0,0,0,0,0
Bajo,No_siniestro,256194,183,3833.79,0,0,0,0,0,0,0,0,0,0,0,0,0,0,0
Bajo,No_siniestro,258170,49,5485.33,0,0,0,0,0,0,0,0,0,0,0,0,0,0,0
Bajo,No_siniestro,258208,158,426.69,0,0,0,0,0,0,0,0,0,0,0,0,0,0,0
Bajo,No_siniestro,258637,45,3513.68,0,0,0,0,0,1,1,2,0,0,0,0,0,0,0
Bajo,No_siniestro,259483,55,6129.05,0,0,0,0,0,0,0,0,0,0,0,0,0,0,0
Bajo,No_siniestro,260137,123,0.01,0,0,0,0,0,0,0,0,0,0,0,0,0,0,0
Bajo,No_siniestro,260332,118,277.35,0,0,0,0,0,0,0,0,0,0,0,0,0,0,0
Bajo,No_siniestro,261026,26,1626.69,0,0,0,0,0,0,0,0,0,0,0,0,0,0,0
Bajo,No_siniestro,261149,7,1484.08,0,0,0,0,0,0,0,0,0,0,0,0,0,0,0
Bajo,No_siniestro,261235,11,470.86,0,0,0,0,0,0,0,0,0,0,0,0,0,0,0
Bajo,No_siniestro,261712,41,179.88,0,0,0,0,0,0,0,0,0,0,0,0,0,0,0
Bajo,No_siniestro,262483,13,854.99,0,0,0,0,0,0,0,0,0,0,0,0,0,0,0
Bajo,No_siniestro,264061,6,1322.9,0,0,0,0,0,0,0,0,0,0,0,0,0,0,0
Bajo,No_siniestro,264068,7,1120.37,0,0,0,0,0,0,0,0,0,0,0,0,0,0,0
Bajo,No_siniestro,264416,34,2169.65,0,0,0,0,0,0,0,0,0,0,0,0,0,0,0
Bajo,No_siniestro,265459,19,655.08,0,0,0,0,0,0,0,0,0,0,0,0,0,0,0
Bajo,No_siniestro,265469,17,4002.97,0,0,0,0,0,0,0,0,0,0,0,0,0,0,0
Bajo,No_siniestro,268337,20,270.19,0,0,0,0,0,0,1,1,0,0,0,0,0,0,0
Bajo,No_siniestro,268574,47,12.01,0,0,0,0,0,0,0,0,0,0,0,0,0,0,0
Bajo,No_siniestro,268927,6,486.87,0,0,0,0,0,0,0,0,0,0,0,0,0,0,0
Bajo,No_siniestro,269349,49,54.06,0,1,1,0,1,1,0,4,0,0,0,0,0,0,0
Bajo,No_siniestro,269442,62,367.31,0,0,0,0,0,0,0,0,0,0,0,0,0,0,0
Bajo,No_siniestro,269584,7,1285.83,0,0,0,0,0,0,0,0,0,0,0,0,0,0,0
Bajo,No_siniestro,269823,176,195.67,0,0,0,0,0,0,0,0,0,0,0,0,0,0,0
Bajo,No_siniestro,270029,50,4771.17,0,1,1,1,0,1,0,4,0,0,0,0,0,0,0
Bajo,No_siniestro,270679,13,1189.24,0,0,0,0,0,0,0,0,0,0,0,0,0,0,0
Bajo,No_siniestro,272506,62,80.58,0,0,0,0,0,0,0,0,0,0,0,0,0,0,0
Bajo,No_siniestro,273697,86,423.97,0,1,0,0,0,0,0,1,0,0,0,0,0,0,0
Bajo,No_siniestro,274296,23,2216.24,0,0,0,0,0,0,0,0,0,0,0,0,0,0,0
Bajo,No_siniestro,275093,17,1565.53,0,0,0,0,0,0,0,0,0,0,0,0,0,0,0
Bajo,No_siniestro,277972,85,910.9,0,0,0,0,0,0,0,0,0,0,0,0,0,0,0
Bajo,No_siniestro,278136,18,570.05,0,0,0,0,0,0,0,0,0,0,0,0,0,0,0
Bajo,No_siniestro,278833,58,257.47,0,0,0,0,0,0,0,0,0,0,0,0,0,0,0
Bajo,No_siniestro,280700,49,1765.29,0,0,1,1,0,1,1,4,0,0,0,0,0,0,0
Bajo,No_siniestro,282405,17,21.45,0,0,0,0,0,0,0,0,0,0,0,0,0,0,0
Bajo,Si_siniestro,282855,80,3.58,0,3,2,3,2,1,0,11,0,0,0,0,0,0,0
Bajo,No_siniestro,282885,19,0.04,0,0,0,0,0,0,0,0,0,0,0,0,0,0,0
Bajo,No_siniestro,285210,49,1893.5,0,0,0,0,0,0,0,0,0,0,0,0,0,0,0
Bajo,No_siniestro,293234,57,924.24,0,0,0,0,0,0,0,0,0,0,0,0,0,0,0
Bajo,No_siniestro,296874,35,48.74,0,0,0,0,0,0,0,0,0,0,0,0,0,0,0
Bajo,Si_siniestro,297395,8,571.42,0,1,0,0,0,0,0,1,0,0,0,0,0,0,0
Bajo,No_siniestro,298457,83,0.02,0,0,0,0,0,0,0,0,0,0,0,0,0,0,0
Bajo,No_siniestro,299331,13,281.58,0,0,0,0,0,0,0,0,0,0,0,0,0,0,0
Bajo,No_siniestro,299928,76,987.55,0,0,0,0,0,0,0,0,0,0,0,0,0,0,0
Bajo,No_siniestro,302654,13,705.52,0,0,0,0,0,0,0,0,0,0,0,0,0,0,0
Bajo,No_siniestro,304335,11,642.08,0,0,0,0,0,0,0,0,0,0,0,0,0,0,0
Bajo,No_siniestro,305213,18,1843.19,0,0,0,0,0,0,0,0,0,0,0,0,0,0,0
Bajo,No_siniestro,307569,27,53.62,0,0,0,0,0,0,0,0,0,0,0,0,0,0,0
Bajo,No_siniestro,308879,6,489.74,0,0,0,0,0,0,0,0,0,0,0,0,0,0,0
Bajo,No_siniestro,311048,10,1323.54,0,0,0,0,0,0,1,1,0,0,0,0,0,0,0
Bajo,No_siniestro,311498,25,28.44,0,0,0,0,0,0,0,0,0,0,0,0,0,0,0
Bajo,No_siniestro,313254,18,146.43,0,0,0,0,0,0,0,0,0,0,0,0,0,0,0
Bajo,No_siniestro,314137,90,905.01,0,0,0,0,0,0,0,0,0,0,0,0,0,0,0
Bajo,No_siniestro,316833,200,2878.77,0,0,0,0,0,0,0,0,0,0,0,0,0,0,0
Bajo,No_siniestro,317862,10,689.62,0,0,0,0,0,0,0,0,0,0,0,0,0,0,0
Bajo,No_siniestro,318707,59,1641.38,0,0,0,0,0,0,0,0,0,0,0,0,0,0,0
Bajo,No_siniestro,320360,49,2330.64,0,0,0,0,0,0,0,0,0,0,0,0,0,0,0
Bajo,No_siniestro,320760,49,8.5,0,0,0,0,0,0,0,0,0,0,0,0,0,0,0
Bajo,No_siniestro,321325,61,4167.84,0,0,0,0,0,0,0,0,0,0,0,0,0,0,0
Bajo,No_siniestro,321808,99,1205.78,0,0,0,0,0,0,0,0,0,0,0,0,0,0,0
Bajo,No_siniestro,322736,92,1898.59,0,0,0,0,0,0,0,0,0,0,0,0,0,0,0
Bajo,No_siniestro,322939,33,700.2,0,0,0,0,0,0,0,0,0,0,0,0,0,0,0
Bajo,No_siniestro,323437,36,1279.55,0,0,0,0,0,0,0,0,0,0,0,0,0,0,0
Bajo,No_siniestro,324330,44,92.83,0,0,0,0,0,0,0,0,0,0,0,0,0,0,0
Bajo,No_siniestro,325383,6,74.87,0,0,0,0,0,0,0,0,0,0,0,0,0,0,0
Bajo,No_siniestro,327109,16,506.01,0,0,0,0,1,0,0,1,0,0,0,0,0,0,0
Bajo,No_siniestro,328140,44,1687.21,0,0,0,0,0,0,0,0,0,0,0,0,0,0,0
Bajo,No_siniestro,328528,7,741.64,0,0,0,0,0,0,0,0,0,0,0,0,0,0,0
Bajo,No_siniestro,328775,61,8845.91,0,0,0,0,0,0,0,0,0,0,0,0,0,0,0
Bajo,No_siniestro,329148,63,2240.04,0,0,0,0,0,0,0,0,0,0,0,0,0,0,0
Bajo,No_siniestro,329924,161,7415.58,0,0,0,0,0,1,0,1,0,0,0,0,0,0,0
Bajo,No_siniestro,330759,186,352.99,0,0,0,0,0,0,0,0,0,0,0,0,0,0,0
Bajo,No_siniestro,330949,9,6399.04,0,0,0,0,0,0,0,0,0,0,0,0,0,0,0
Bajo,No_siniestro,332910,44,9130.54,0,0,0,0,0,0,1,1,0,0,0,0,0,0,0
Bajo,No_siniestro,334604,88,694.75,0,0,0,0,0,0,0,0,0,0,0,0,0,0,0
Bajo,No_siniestro,335052,107,12.18,0,0,1,1,0,2,1,5,0,0,0,0,0,0,0
Bajo,No_siniestro,335904,23,319.25,0,0,0,0,0,0,0,0,0,0,0,0,0,0,0
Bajo,Si_siniestro,336182,11,3383.8,0,0,0,0,0,0,0,0,0,0,0,0,0,0,0
Bajo,No_siniestro,337263,13,443.64,0,0,0,0,0,0,0,0,0,0,0,0,0,0,0
Bajo,No_siniestro,338219,11,406.34,0,0,0,0,0,0,0,0,0,0,0,0,0,0,0
Bajo,No_siniestro,338971,6,2464.81,0,0,0,0,0,0,0,0,0,0,0,0,0,0,0
Bajo,No_siniestro,339066,12,527.7,0,0,0,0,0,0,0,0,0,0,0,0,0,0,0
Bajo,No_siniestro,339292,18,2644.49,0,0,0,0,0,0,0,0,0,0,0,0,0,0,0
Bajo,No_siniestro,339345,9,800.84,0,0,0,0,0,0,0,0,0,0,0,0,0,0,0
Bajo,No_siniestro,340311,90,2808.98,0,0,1,0,0,0,0,1,0,0,0,0,0,0,0
Bajo,No_siniestro,340633,61,8227.82,0,0,0,0,0,0,0,0,0,0,0,0,0,0,0
Bajo,No_siniestro,341727,19,626.76,0,1,1,1,1,1,1,6,0,0,0,0,0,0,0
Bajo,No_siniestro,342029,63,226.45,0,0,0,0,0,0,0,0,0,0,0,0,0,0,0
Bajo,No_siniestro,342424,6,2924.26,0,0,0,0,0,0,0,0,0,0,0,0,0,0,0
Bajo,No_siniestro,342736,17,1354.09,0,0,0,0,0,0,0,0,0,0,0,0,0,0,0
Bajo,No_siniestro,343577,21,111.72,0,0,0,0,0,0,0,0,0,0,0,0,0,0,0
Bajo,No_siniestro,344111,52,4592.5,0,0,0,0,0,0,0,0,0,0,0,0,0,0,0
Bajo,No_siniestro,344786,24,206.56,0,0,0,0,0,0,0,0,0,0,0,0,0,0,0
Bajo,No_siniestro,346505,32,344.84,0,0,0,0,0,0,0,0,0,0,0,0,0,0,0
Bajo,No_siniestro,347666,15,0.77,0,0,1,1,1,0,0,3,0,0,0,0,0,0,0
Bajo,No_siniestro,348155,27,4367.57,0,0,0,0,0,0,0,0,0,0,0,0,0,0,0
Bajo,No_siniestro,348616,79,167.3,0,0,0,0,0,0,0,0,0,0,0,0,0,0,0
Bajo,No_siniestro,348980,44,355.87,0,0,0,0,0,0,0,0,0,0,0,0,0,0,0
Bajo,No_siniestro,349654,20,99.18,0,0,0,0,0,0,0,0,0,0,0,0,0,0,0
Bajo,No_siniestro,349854,107,2163.41,0,0,0,0,0,0,0,0,0,0,0,0,0,0,0
Bajo,No_siniestro,353283,66,130.87,0,0,0,0,0,0,0,0,0,0,0,0,0,0,0
Bajo,No_siniestro,354105,6,413.13,0,0,0,0,0,0,0,0,0,0,0,0,0,0,0
Bajo,No_siniestro,354594,162,5648.09,0,0,0,0,0,0,0,0,0,0,0,0,0,0,0
Bajo,No_siniestro,356173,107,654.9,0,0,0,1,1,1,0,3,0,0,0,0,0,0,0
Bajo,No_siniestro,358311,65,1575.81,0,0,0,0,0,0,0,0,0,0,0,0,0,0,0
Bajo,No_siniestro,358428,10,2025.68,0,0,0,0,0,0,0,0,0,0,0,0,0,0,0
Bajo,No_siniestro,359097,81,532.14,0,0,0,0,0,0,0,0,0,0,0,0,0,0,0
Bajo,No_siniestro,360765,31,1195.57,0,0,0,0,0,0,0,0,0,0,0,0,0,0,0
Bajo,No_siniestro,360978,9,97.02,0,0,0,0,0,0,0,0,0,0,0,0,0,0,0
Bajo,No_siniestro,364560,44,753.44,0,0,0,0,0,0,0,0,0,0,0,0,0,0,0
Bajo,No_siniestro,365652,20,551.39,0,0,0,0,0,0,0,0,0,0,0,0,0,0,0
Bajo,No_siniestro,365680,44,4459.65,0,0,0,0,0,0,0,0,0,0,0,0,0,0,0
Bajo,No_siniestro,366071,87,445.01,0,0,0,0,0,0,0,0,0,0,0,0,0,0,0
Bajo,Si_siniestro,367276,8,1463.63,0,0,1,0,0,0,0,1,0,0,0,0,0,0,0
Bajo,No_siniestro,367493,26,602.5,0,0,0,0,0,0,0,0,0,0,0,0,0,0,0
Bajo,No_siniestro,367507,16,1187.54,0,0,0,0,0,0,0,0,0,0,0,0,0,0,0
Bajo,No_siniestro,369264,19,380.56,0,0,0,0,0,0,0,0,0,0,0,0,0,0,0
Bajo,No_siniestro,369348,6,9.4,0,0,0,0,0,0,0,0,0,0,0,0,0,0,0
Bajo,No_siniestro,369439,11,490.46,0,0,0,0,0,0,0,0,0,0,0,0,0,0,0
Bajo,No_siniestro,369944,23,178.11,0,0,0,0,0,0,0,0,0,0,0,0,0,0,0
Bajo,No_siniestro,370422,13,56.82,0,0,0,0,0,0,0,0,0,0,0,0,0,0,0
Bajo,No_siniestro,370470,44,220.87,0,0,0,0,0,0,0,0,0,0,0,0,0,0,0
Bajo,No_siniestro,371105,20,57.04,0,0,0,0,1,0,0,1,0,0,0,0,0,0,0
Bajo,No_siniestro,371194,9,1130.85,0,0,0,0,0,0,0,0,0,0,0,0,0,0,0
Bajo,No_siniestro,371318,8,946.69,0,0,0,1,0,0,0,1,0,0,0,0,0,0,0
Bajo,No_siniestro,373070,44,1033.34,0,0,0,0,0,0,0,0,0,0,0,0,0,0,0
Bajo,No_siniestro,374529,55,459.64,0,0,0,1,0,1,0,2,0,0,0,0,0,0,0
Bajo,No_siniestro,374753,6,32.9,0,0,0,0,0,0,0,0,0,0,0,0,0,0,0
Bajo,No_siniestro,375089,7,3987.18,0,0,0,0,0,0,0,0,0,0,0,0,0,0,0
Bajo,No_siniestro,375522,22,844.26,0,0,0,0,0,1,0,1,0,0,0,0,0,0,0
Bajo,No_siniestro,376508,25,362.98,0,0,0,0,0,1,0,1,0,0,0,0,0,0,0
Bajo,Si_siniestro,376655,9,1233.81,0,0,0,0,0,0,0,0,0,0,0,0,0,0,0
Bajo,No_siniestro,377014,35,1665.68,0,0,0,0,0,0,0,0,0,0,0,0,0,0,0
Bajo,No_siniestro,377444,7,1610.44,0,0,0,0,0,0,0,0,0,0,0,0,0,0,0
Bajo,No_siniestro,377770,44,36.49,0,0,0,0,0,0,0,0,0,0,0,0,0,0,0
Bajo,No_siniestro,377788,12,209.15,0,0,0,0,0,0,0,0,0,0,0,0,0,0,0
Bajo,No_siniestro,378304,16,180,0,0,0,0,0,0,0,0,0,0,0,0,0,0,0
Bajo,No_siniestro,378863,39,66.58,0,0,0,0,0,0,0,0,0,0,0,0,0,0,0
Bajo,No_siniestro,381772,133,315.19,0,0,0,0,0,0,0,0,0,0,0,0,0,0,0
Bajo,No_siniestro,381905,134,1222.07,0,0,0,0,0,0,0,0,0,0,0,0,0,0,0
Bajo,No_siniestro,381931,10,3503.83,0,0,0,0,0,0,0,0,0,0,0,0,0,0,0
Bajo,No_siniestro,382100,44,281.08,0,0,0,0,0,0,0,0,0,0,0,0,0,0,0
Bajo,No_siniestro,382168,11,1362.26,0,0,0,0,1,1,1,3,0,0,0,0,0,0,0
Bajo,No_siniestro,383295,134,5335.54,0,0,0,0,0,0,0,0,0,0,0,0,0,0,0
Bajo,No_siniestro,384790,44,1480.05,0,0,0,0,0,0,0,0,0,0,0,0,0,0,0
Bajo,No_siniestro,386337,113,4062.83,0,0,0,0,0,0,0,0,0,0,0,0,0,0,0
Bajo,No_siniestro,387861,56,4266.33,0,0,0,0,0,0,0,0,0,0,0,0,0,0,0
Bajo,No_siniestro,390858,39,488.41,0,0,0,0,0,0,0,0,0,0,0,0,0,0,0
Bajo,No_siniestro,391043,161,338.19,0,0,0,0,0,0,0,0,0,0,0,0,0,0,0
Bajo,No_siniestro,392063,12,1343.61,0,0,0,0,0,0,0,0,0,0,0,0,0,0,0
Bajo,No_siniestro,392096,104,1280.83,0,0,0,0,0,0,0,0,0,0,0,0,0,0,0
Bajo,No_siniestro,392582,151,1128.49,0,0,0,0,0,0,0,0,0,0,0,0,0,0,0
Bajo,No_siniestro,392710,44,837.72,0,0,0,0,0,0,0,0,0,0,0,0,0,0,0
Bajo,No_siniestro,392990,44,4866.95,0,0,0,0,0,0,0,0,0,0,0,0,0,0,0
Bajo,No_siniestro,393520,44,386.7,0,0,0,0,0,0,0,0,0,0,0,0,0,0,0
Bajo,No_siniestro,394017,61,1730.85,0,0,0,0,1,1,0,2,0,0,0,0,0,0,0
Bajo,No_siniestro,394171,8,494.04,0,1,0,0,0,0,0,1,0,0,0,0,0,0,0
Bajo,No_siniestro,394773,18,0.04,0,0,0,0,0,0,0,0,0,0,0,0,0,0,0
Bajo,No_siniestro,395069,10,449.34,0,0,0,0,0,0,0,0,0,0,0,0,0,0,0
Bajo,No_siniestro,395368,14,1221.74,0,0,0,1,0,0,0,1,0,0,0,0,0,0,0
Bajo,No_siniestro,396224,7,1146.13,0,0,0,0,0,0,0,0,0,0,0,0,0,0,0
Bajo,No_siniestro,397938,9,2139.95,0,1,0,0,0,0,0,1,0,0,0,0,0,0,0
Bajo,Si_siniestro,399288,16,52.67,0,0,0,0,0,0,0,0,0,0,0,0,0,0,0
Bajo,Si_siniestro,400310,44,287.94,0,0,0,0,0,0,0,0,0,0,0,0,0,0,0
Bajo,No_siniestro,400336,52,470.46,0,0,0,0,0,0,0,0,0,0,0,0,0,0,0
Bajo,No_siniestro,400475,148,205.99,0,0,0,0,0,0,0,0,0,0,0,0,0,0,0
Bajo,No_siniestro,400740,44,574.41,0,0,0,0,0,0,0,0,0,0,0,0,0,0,0
Bajo,No_siniestro,403947,11,1966.38,0,0,0,0,0,0,0,0,0,0,0,0,0,0,0
Bajo,No_siniestro,404114,12,2930.9,0,0,0,0,0,0,0,0,0,0,0,0,0,0,0
Bajo,No_siniestro,405792,38,23.1,0,0,0,0,0,0,0,0,0,0,0,0,0,0,0
Bajo,No_siniestro,407133,9,874.72,0,0,0,0,0,0,0,0,0,0,0,0,0,0,0
Bajo,No_siniestro,408779,84,435.31,0,0,0,0,0,0,0,0,0,0,0,0,0,0,0
Bajo,No_siniestro,410073,10,429.38,0,0,0,0,0,0,0,0,0,0,0,0,0,0,0
Bajo,No_siniestro,411952,12,333.4,0,0,0,0,0,0,0,0,0,0,0,0,0,0,0
Bajo,No_siniestro,412243,6,1724.94,0,0,0,0,0,0,0,0,0,0,0,0,0,0,0
Bajo,No_siniestro,413193,60,11374.66,0,0,0,0,1,0,1,2,0,0,0,0,0,0,0
Bajo,No_siniestro,413557,11,7225.53,0,0,1,1,1,0,1,4,0,0,0,0,0,0,0
Bajo,No_siniestro,414609,104,76.52,0,0,0,0,0,0,0,0,0,0,0,0,0,0,0
Bajo,No_siniestro,414708,97,736.6,0,0,0,0,0,0,0,0,0,0,0,0,0,0,0
Bajo,No_siniestro,414999,8,1859.29,0,1,1,0,0,0,0,2,0,0,0,0,0,0,0
Bajo,No_siniestro,417539,103,204.69,0,0,0,0,0,0,0,0,0,0,0,0,0,0,0
Bajo,No_siniestro,418859,24,2420.43,0,0,0,0,0,0,0,0,0,0,0,0,0,0,0
Bajo,No_siniestro,419444,41,167.51,0,0,0,0,0,0,0,0,0,0,0,0,0,0,0
Bajo,No_siniestro,420415,22,944.8,0,0,0,0,0,0,0,0,0,0,0,0,0,0,0
Bajo,No_siniestro,421535,14,24.45,0,0,0,0,0,0,0,0,0,0,0,0,0,0,0
Bajo,No_siniestro,422076,6,352.47,0,0,0,0,0,0,0,0,0,0,0,0,0,0,0
Bajo,No_siniestro,423017,57,555.73,0,0,0,0,2,1,1,4,0,0,0,0,0,0,0
Bajo,Si_siniestro,424182,22,2909.8,0,0,0,0,0,0,0,0,0,0,0,0,0,0,0
Bajo,No_siniestro,425474,53,425.99,0,0,0,1,1,0,0,2,0,0,0,0,0,0,0
Bajo,No_siniestro,426859,49,93.33,0,0,0,0,0,0,0,0,0,0,0,0,0,0,0
Bajo,No_siniestro,427539,6,1267.68,0,0,0,0,0,0,0,0,0,0,0,0,0,0,0
Bajo,No_siniestro,427589,107,2078.14,0,1,1,1,1,0,1,5,0,0,0,0,0,0,0
Bajo,No_siniestro,428525,79,0.02,0,0,0,0,0,0,0,0,0,0,0,0,0,0,0
Bajo,No_siniestro,428648,20,1,0,0,0,0,0,0,0,0,0,0,0,0,0,0,0
Bajo,No_siniestro,429753,109,17.89,0,0,0,0,0,0,0,0,0,0,0,0,0,0,0
Bajo,No_siniestro,430016,11,1756.28,0,0,0,0,0,0,0,0,0,0,0,0,0,0,0
Bajo,No_siniestro,430145,87,740.37,0,0,0,0,0,0,0,0,0,0,0,0,0,0,0
Bajo,No_siniestro,432326,11,1939.4,0,0,0,0,0,0,0,0,0,0,0,0,0,0,0
Bajo,No_siniestro,432607,22,632.82,0,0,0,0,0,0,0,0,0,0,0,0,0,0,0
Bajo,No_siniestro,432760,44,238.98,0,0,0,0,0,0,0,0,0,0,0,0,0,0,0
Bajo,No_siniestro,433223,77,39.48,0,0,0,0,0,0,0,0,0,0,0,0,0,0,0
Bajo,No_siniestro,434982,36,53.57,0,0,0,0,0,0,0,0,0,0,0,0,0,0,0
Bajo,No_siniestro,435199,76,1123.6,0,0,0,0,0,0,0,0,0,0,0,0,0,0,0
Bajo,No_siniestro,437295,17,1497.51,0,0,0,0,0,0,0,0,0,0,0,0,0,0,0
Bajo,Si_siniestro,437605,15,138.33,0,0,0,0,0,0,0,0,0,0,0,0,0,0,0
Bajo,No_siniestro,437815,61,4125.93,0,0,0,0,0,0,0,0,0,0,0,0,0,0,0
Bajo,No_siniestro,441717,12,526.4,0,0,0,0,0,0,0,0,0,0,0,0,0,0,0
Bajo,No_siniestro,441977,48,3051,0,0,0,0,0,0,0,0,0,0,0,0,0,0,0
Bajo,No_siniestro,442039,17,625.15,0,0,0,0,0,0,0,0,0,0,0,0,0,0,0
Bajo,No_siniestro,442765,29,465.72,0,0,0,0,0,0,0,0,0,0,0,0,0,0,0
Bajo,No_siniestro,443194,56,51.93,0,0,0,0,0,0,0,0,0,0,0,0,0,0,0
Bajo,No_siniestro,444233,10,2298.54,0,3,2,2,1,1,0,9,0,0,0,0,0,0,0
Bajo,No_siniestro,445033,9,1210.86,0,0,0,0,0,0,0,0,0,0,0,0,0,0,0
Bajo,No_siniestro,445470,44,1523.11,0,0,0,0,0,0,0,0,0,0,0,0,0,0,0
Bajo,No_siniestro,446681,50,385.28,0,0,0,0,0,0,0,0,0,0,0,0,0,0,0
Bajo,No_siniestro,447255,6,3537.82,0,0,0,0,0,0,0,0,0,0,0,0,0,0,0
Bajo,No_siniestro,448801,14,1627.43,0,0,0,0,0,0,0,0,0,0,0,0,0,0,0
Bajo,No_siniestro,450168,13,1241.58,0,0,0,0,0,0,0,0,0,0,0,0,0,0,0
Bajo,No_siniestro,450334,8,1580.33,0,0,0,0,0,0,0,0,0,0,0,0,0,0,0
Bajo,No_siniestro,452273,143,1287.22,0,0,0,0,1,0,0,1,0,0,0,0,0,0,0
Bajo,No_siniestro,453417,25,1056.36,0,0,0,0,0,0,0,0,0,0,0,0,0,0,0
Bajo,No_siniestro,453801,106,6145.51,0,0,0,0,0,0,0,0,0,0,0,0,0,0,0
Bajo,No_siniestro,456051,11,2169.16,0,0,0,0,0,0,0,0,0,0,0,0,0,0,0
Bajo,Si_siniestro,456823,9,465.46,0,0,0,0,0,0,0,0,0,0,0,0,0,0,0
Bajo,No_siniestro,457047,11,831.3,0,0,0,0,0,0,0,0,0,0,0,0,0,0,0
Bajo,No_siniestro,460196,28,1310.95,0,1,1,1,0,0,0,3,0,0,0,0,0,0,0
Bajo,No_siniestro,460781,197,36.83,0,0,0,0,0,0,0,0,0,0,0,0,0,0,0
Bajo,No_siniestro,460803,111,475.69,0,0,0,0,0,0,0,0,0,0,0,0,0,0,0
Bajo,No_siniestro,461248,34,45.94,0,0,0,0,0,0,0,0,0,0,0,0,0,0,0
Bajo,No_siniestro,461263,29,4104.51,0,0,0,0,0,0,0,0,0,0,0,0,0,0,0
Bajo,No_siniestro,462032,10,373.8,0,0,0,0,0,0,0,0,0,0,0,0,0,0,0
Bajo,No_siniestro,462159,32,1902.75,0,0,1,0,0,0,0,1,0,0,0,0,0,0,0
Bajo,No_siniestro,464497,18,3188.36,0,0,0,0,0,0,0,0,0,0,0,0,0,0,0
Bajo,Si_siniestro,465255,7,413.93,0,0,0,4,3,2,1,10,0,0,0,0,0,0,0
Bajo,No_siniestro,465506,55,1339.69,0,0,0,0,0,0,0,0,0,0,0,0,0,0,0
Bajo,No_siniestro,465733,42,667.99,0,0,0,0,0,0,0,0,0,0,0,0,0,0,0
Bajo,No_siniestro,467766,50,1344.89,0,0,0,0,0,0,0,0,0,0,0,0,0,0,0
Bajo,No_siniestro,468306,17,566.88,0,0,1,1,1,0,1,4,0,0,0,0,0,0,0
Bajo,No_siniestro,468840,40,372.13,0,0,0,0,0,0,0,0,0,0,0,0,0,0,0
Bajo,No_siniestro,468854,8,1036.08,0,0,0,0,0,0,0,0,0,0,0,0,0,0,0
Bajo,Si_siniestro,470622,9,3586.42,0,0,0,0,0,0,0,0,0,0,0,0,0,0,0
Bajo,No_siniestro,470643,88,68.44,0,0,0,0,0,1,0,1,0,0,0,0,0,0,0
Bajo,No_siniestro,470994,9,298.46,0,0,0,0,0,0,0,0,0,0,0,0,0,0,0
Bajo,No_siniestro,471032,120,337.68,0,0,0,0,0,0,0,0,0,0,0,0,0,0,0
Bajo,No_siniestro,473122,111,398.88,0,0,0,0,0,0,0,0,0,0,0,0,0,0,0
Bajo,No_siniestro,473204,13,6506.22,0,0,0,0,0,0,0,0,0,0,0,0,0,0,0
Bajo,No_siniestro,473580,40,7539.34,0,0,0,0,0,0,0,0,0,0,0,0,0,0,0
Bajo,No_siniestro,473598,87,1398.51,0,0,1,0,1,0,1,3,0,0,0,0,0,0,0
Bajo,No_siniestro,474116,12,682.04,0,0,0,0,0,0,0,0,0,0,0,0,0,0,0
Bajo,No_siniestro,474823,47,1946.65,0,0,0,0,0,0,0,0,0,0,0,0,0,0,0
Bajo,Si_siniestro,475971,14,1878.96,0,1,0,0,0,0,0,1,0,0,0,0,0,0,0
Bajo,No_siniestro,476353,9,2687.71,0,0,0,0,0,0,0,0,0,0,0,0,0,0,0
Bajo,No_siniestro,476477,11,1236.39,0,0,0,0,0,0,0,0,0,0,0,0,0,0,0
Bajo,No_siniestro,477242,21,1743.8,0,0,0,0,0,0,0,0,0,0,0,0,0,0,0
Bajo,No_siniestro,477372,19,1409.26,0,0,0,0,0,0,0,0,0,0,0,0,0,0,0
Bajo,No_siniestro,477583,7,746.14,0,0,0,0,0,0,0,0,0,0,0,0,0,0,0
Bajo,No_siniestro,478024,6,1346.16,0,0,0,0,0,0,0,0,0,0,0,0,0,0,0
Bajo,No_siniestro,478516,73,1418.84,0,1,0,0,1,1,1,4,0,0,0,0,0,0,0
Bajo,No_siniestro,482038,14,1319.7,0,0,0,0,0,0,0,0,0,0,0,0,0,0,0
Bajo,No_siniestro,483309,18,2553.75,0,0,0,0,0,1,0,1,0,0,0,0,0,0,0
Bajo,No_siniestro,484173,21,214.51,0,0,0,0,0,0,0,0,0,0,0,0,0,0,0
Bajo,No_siniestro,484599,15,1851.21,0,0,0,0,0,0,0,0,0,0,0,0,0,0,0
Bajo,No_siniestro,484630,40,61.14,0,0,0,0,0,0,0,0,0,0,0,0,0,0,0
Bajo,No_siniestro,484799,38,1362.67,0,0,0,0,0,0,0,0,0,0,0,0,0,0,0
Bajo,No_siniestro,484813,7,475.87,0,0,0,0,0,0,0,0,0,0,0,0,0,0,0
Bajo,No_siniestro,485041,9,1623.87,0,0,0,0,0,0,0,0,0,0,0,0,0,0,0
Bajo,No_siniestro,486490,40,781.01,0,0,0,0,0,0,0,0,0,0,0,0,0,0,0
Bajo,No_siniestro,486662,133,883.97,0,0,0,0,0,0,0,0,0,0,0,0,0,0,0
Bajo,No_siniestro,488505,15,3894.47,0,0,0,0,0,0,0,0,0,0,0,0,0,0,0
Bajo,No_siniestro,488693,6,2858.42,0,0,0,0,0,0,0,0,0,0,0,0,0,0,0
Bajo,No_siniestro,489398,7,3471.09,0,0,0,0,0,0,0,0,0,0,0,0,0,0,0
Bajo,No_siniestro,489571,60,1251.18,0,0,0,1,0,0,0,1,0,0,0,0,0,0,0
Bajo,No_siniestro,491031,10,325.87,0,0,0,0,0,0,0,0,0,0,0,0,0,0,0
Bajo,No_siniestro,491669,112,2899.95,0,0,0,0,0,0,0,0,0,0,0,0,0,0,0
Bajo,No_siniestro,493049,80,0.11,0,0,0,0,0,0,0,0,0,0,0,0,0,0,0
Bajo,No_siniestro,493689,62,1043.7,0,0,0,0,0,0,0,0,0,0,0,0,0,0,0
Bajo,No_siniestro,493702,40,968.57,0,0,0,0,0,0,0,0,0,0,0,0,0,0,0
Bajo,No_siniestro,495518,9,2201.9,0,0,0,0,0,0,0,0,0,0,0,0,0,0,0
Bajo,No_siniestro,495545,31,0.74,0,0,0,0,0,0,0,0,0,0,0,0,0,0,0
Bajo,No_siniestro,496210,40,62.17,0,0,0,0,0,0,0,0,0,0,0,0,0,0,0
Bajo,No_siniestro,496552,91,402.2,0,0,0,0,0,0,0,0,0,0,0,0,0,0,0
Bajo,No_siniestro,496998,29,2102.03,0,0,0,0,0,0,0,0,0,0,0,0,0,0,0
Bajo,No_siniestro,497658,22,146.49,0,0,0,0,0,0,0,0,0,0,0,0,0,0,0
Bajo,No_siniestro,497796,14,915.02,0,0,0,0,0,0,0,0,0,0,0,0,0,0,0
Bajo,No_siniestro,498308,39,110.47,0,0,0,0,0,0,0,0,0,0,0,0,0,0,0
Bajo,No_siniestro,498350,40,784.99,0,0,0,0,0,0,0,0,0,0,0,0,0,0,0
Bajo,Si_siniestro,499498,13,605.55,0,1,1,0,0,0,0,2,0,0,0,0,0,0,0
Bajo,No_siniestro,499541,12,886.76,0,0,0,0,0,0,0,0,0,0,0,0,0,0,0
Bajo,No_siniestro,501017,16,691.63,0,0,0,0,0,0,0,0,0,0,0,0,0,0,0
Bajo,No_siniestro,501132,34,0.02,0,0,0,0,0,0,0,0,0,0,0,0,0,0,0
Bajo,No_siniestro,501469,14,697.05,0,1,0,0,0,0,0,1,0,0,0,0,0,0,0
Bajo,No_siniestro,502892,91,0.05,0,0,0,0,0,0,0,0,0,0,0,0,0,0,0
Bajo,Si_siniestro,504318,7,2860.02,0,1,1,0,0,1,0,3,0,0,0,0,0,0,0
Bajo,No_siniestro,504342,59,861.5,0,0,0,0,0,0,0,0,0,0,0,0,0,0,0
Bajo,No_siniestro,507085,11,488.81,0,0,0,0,0,0,0,0,0,0,0,0,0,0,0
Bajo,No_siniestro,507197,10,101.9,0,0,0,0,0,0,0,0,0,0,0,0,0,0,0
Bajo,Si_siniestro,507754,6,1357.17,0,0,1,0,0,0,0,1,0,0,0,0,0,0,0
Bajo,Si_siniestro,507943,11,1024.44,0,0,0,0,0,0,0,0,0,0,0,0,0,0,0
Bajo,No_siniestro,508475,13,283.99,0,0,0,0,0,0,0,0,0,0,0,0,0,0,0
Bajo,Si_siniestro,510833,12,594,0,0,0,0,0,0,0,0,0,0,0,0,0,0,0
Bajo,No_siniestro,511389,49,792.54,0,0,0,0,0,0,0,0,0,0,0,0,0,0,0
Bajo,No_siniestro,512223,61,1160.36,0,0,0,0,0,0,0,0,0,0,0,0,0,0,0
Bajo,No_siniestro,512815,16,1942.79,0,0,0,0,0,0,0,0,0,0,0,0,0,0,0
Bajo,No_siniestro,515411,85,4534.31,0,0,0,0,0,0,0,0,0,0,0,0,0,0,0
Bajo,No_siniestro,515711,31,1188.9,0,0,0,0,0,0,0,0,0,0,0,0,0,0,0
Bajo,No_siniestro,515742,65,253.95,0,0,0,0,0,0,0,0,0,0,0,0,0,0,0
Bajo,No_siniestro,516929,62,833.23,0,0,0,0,0,0,0,0,0,0,0,0,0,0,0
Bajo,No_siniestro,517836,114,248.76,0,1,1,1,1,1,1,6,0,0,0,0,0,0,0
Bajo,No_siniestro,519252,119,2.09,0,0,0,0,0,0,0,0,0,0,0,0,0,0,0
Bajo,No_siniestro,519616,7,1012.27,0,1,0,1,1,1,1,5,0,0,0,0,0,0,0
Bajo,No_siniestro,519839,10,1370.54,0,0,0,1,0,0,0,1,0,0,0,0,0,0,0
Bajo,No_siniestro,521112,15,1528.23,0,0,0,0,1,0,0,1,0,0,0,0,0,0,0
Bajo,No_siniestro,521426,60,943.12,0,0,0,0,0,0,0,0,0,0,0,0,0,0,0
Bajo,No_siniestro,522004,7,738.07,0,0,0,0,0,0,0,0,0,0,0,0,0,0,0
Bajo,No_siniestro,522543,117,2835.52,0,0,0,0,0,0,0,0,0,0,0,0,0,0,0
Bajo,No_siniestro,523144,17,744.8,0,0,0,0,0,0,0,0,0,0,0,0,0,0,0
Bajo,No_siniestro,523937,66,884.52,0,0,0,0,0,0,0,0,0,0,0,0,0,0,0
Bajo,No_siniestro,524789,51,1230.52,0,0,0,0,0,0,0,0,0,0,0,0,0,0,0
Bajo,No_siniestro,525907,107,744.03,0,0,0,0,0,0,0,0,0,0,0,0,0,0,0
Bajo,No_siniestro,526540,40,5045.35,0,0,0,0,0,0,0,0,0,0,0,0,0,0,0
Bajo,No_siniestro,528016,12,984.26,0,0,0,0,0,0,0,0,0,0,0,0,0,0,0
Bajo,No_siniestro,531040,40,363.68,0,0,0,0,0,0,0,0,0,0,0,0,0,0,0
Bajo,No_siniestro,531943,6,1279.8,0,0,0,0,0,0,0,0,0,0,0,0,0,0,0
Bajo,No_siniestro,532630,40,337.07,0,0,0,0,0,0,0,0,0,0,0,0,0,0,0
Bajo,No_siniestro,533739,125,343.31,0,0,0,0,0,0,0,0,0,0,0,0,0,0,0
Bajo,No_siniestro,534021,13,1126.77,0,0,0,0,0,0,0,0,0,0,0,0,0,0,0
Bajo,No_siniestro,535056,35,392.48,0,0,0,0,0,0,0,0,0,0,0,0,0,0,0
Bajo,No_siniestro,535825,23,1757.77,0,0,0,0,0,0,0,0,0,0,0,0,0,0,0
Bajo,No_siniestro,537310,40,3302.5,0,0,0,0,0,0,0,0,0,0,0,0,0,0,0
Bajo,No_siniestro,539801,17,6.48,0,0,0,0,0,0,0,0,0,0,0,0,0,0,0
Bajo,No_siniestro,541605,6,1617.76,0,0,0,0,0,0,0,0,0,0,0,0,0,0,0
Bajo,No_siniestro,542116,12,853.71,0,0,0,0,0,0,0,0,0,0,0,0,0,0,0
Bajo,No_siniestro,542117,12,612.21,0,0,0,0,0,0,0,0,0,0,0,0,0,0,0
Bajo,No_siniestro,544082,61,495.59,0,0,0,0,0,1,1,2,0,0,0,0,0,0,0
Bajo,No_siniestro,544266,6,1446.16,0,0,0,0,0,0,0,0,0,0,0,0,0,0,0
Bajo,No_siniestro,545097,63,132.91,0,0,0,0,0,0,0,0,0,0,0,0,0,0,0
Bajo,No_siniestro,546276,6,669.89,0,0,0,0,0,0,0,0,0,0,0,0,0,0,0
Bajo,No_siniestro,548740,40,883.76,0,0,0,0,3,0,0,3,0,0,0,0,0,0,0
Bajo,No_siniestro,549449,20,1371.16,0,0,0,0,0,0,0,0,0,0,0,0,0,0,0
Bajo,No_siniestro,551074,102,773.91,0,0,0,1,0,1,0,2,0,0,0,0,0,0,0
Bajo,No_siniestro,551185,18,45.39,0,0,0,0,0,0,0,0,0,0,0,0,0,0,0
Bajo,No_siniestro,551429,30,2233.55,0,0,0,0,0,0,0,0,0,0,0,0,0,0,0
Bajo,Si_siniestro,553696,9,3281.53,0,0,0,0,0,0,0,0,0,0,0,0,0,0,0
Bajo,No_siniestro,554382,164,2085.31,0,0,0,0,0,0,0,0,0,0,0,0,0,0,0
Bajo,No_siniestro,554416,53,40.21,0,0,0,0,0,0,0,0,0,0,0,0,0,0,0
Bajo,No_siniestro,555244,14,1578.66,0,0,0,0,0,0,0,0,0,0,0,0,0,0,0
Bajo,No_siniestro,555328,6,3453.27,0,0,0,0,0,0,0,0,0,0,0,0,0,0,0
Bajo,No_siniestro,557984,10,1107.63,0,0,0,0,0,0,0,0,0,0,0,0,0,0,0
Bajo,No_siniestro,560056,9,1100.13,0,0,0,0,0,0,0,0,0,0,0,0,0,0,0
Bajo,No_siniestro,560118,10,1065.82,0,0,0,0,0,0,0,0,0,0,0,0,0,0,0
Bajo,No_siniestro,560455,52,547.81,0,0,0,0,0,0,0,0,0,0,0,0,0,0,0
Bajo,No_siniestro,561051,7,452.73,0,0,0,0,0,0,0,0,0,0,0,0,0,0,0
Bajo,No_siniestro,563176,7,1008.07,0,0,0,0,0,0,0,0,0,0,0,0,0,0,0
Bajo,No_siniestro,563402,52,112.5,0,0,0,0,0,1,0,1,0,0,0,0,0,0,0
Bajo,No_siniestro,563924,6,195.8,0,0,0,0,0,0,0,0,0,0,0,0,0,0,0
Bajo,No_siniestro,564515,114,242.37,0,0,0,0,0,0,0,0,0,0,0,0,0,0,0
Bajo,No_siniestro,565668,18,68.29,0,0,0,0,0,0,0,0,0,0,0,0,0,0,0
Bajo,No_siniestro,567516,13,173.7,0,0,0,0,0,0,0,0,0,0,0,0,0,0,0
Bajo,No_siniestro,568715,12,1895.71,0,0,0,0,0,0,0,0,0,0,0,0,0,0,0
Bajo,No_siniestro,569134,11,1374.09,0,0,0,0,0,0,0,0,0,0,0,0,0,0,0
Bajo,No_siniestro,569280,40,341.98,0,0,0,0,0,0,0,0,0,0,0,0,0,0,0
Bajo,No_siniestro,569412,50,1051.25,0,0,0,0,0,0,0,0,0,0,0,0,0,0,0
Bajo,No_siniestro,570440,40,1263.18,0,0,0,0,0,1,0,1,0,0,0,0,0,0,0
Bajo,Si_siniestro,571773,8,877.04,0,0,0,0,0,0,0,0,0,0,0,0,0,0,0
Bajo,No_siniestro,572565,8,26.03,0,0,0,0,0,0,0,0,0,0,0,0,0,0,0
Bajo,No_siniestro,573113,9,998.47,0,0,0,0,0,0,0,0,0,0,0,0,0,0,0
Bajo,No_siniestro,573255,12,6157.26,0,0,0,0,0,0,0,0,0,0,0,0,0,0,0
Bajo,No_siniestro,573815,11,849.62,0,0,0,0,0,0,0,0,0,0,0,0,0,0,0
Bajo,No_siniestro,574261,12,254.25,0,0,0,0,0,0,0,0,0,0,0,0,0,0,0
Bajo,No_siniestro,574483,6,430.65,0,0,0,0,0,0,0,0,0,0,0,0,0,0,0
Bajo,No_siniestro,574691,11,286.11,0,0,0,0,0,0,0,0,0,0,0,0,0,0,0
Bajo,No_siniestro,575074,8,357.48,0,0,0,0,0,0,0,0,0,0,0,0,0,0,0
Bajo,No_siniestro,575335,11,2778.68,0,0,0,0,0,0,0,0,0,0,0,0,0,0,0
Bajo,No_siniestro,576381,10,3211.46,0,0,0,0,0,0,0,0,0,0,0,0,0,0,0
Bajo,No_siniestro,577350,40,402.68,0,0,0,0,0,0,0,0,0,0,0,0,0,0,0
Bajo,No_siniestro,577882,7,1463.29,0,0,0,0,0,0,0,0,0,0,0,0,0,0,0
Bajo,No_siniestro,578229,6,339.23,0,0,0,0,0,0,0,0,0,0,0,0,0,0,0
Bajo,No_siniestro,580011,81,961.16,0,0,0,0,0,0,0,0,0,0,0,0,0,0,0
Bajo,No_siniestro,580483,7,321.42,0,0,0,0,0,0,0,0,0,0,0,0,0,0,0
Bajo,No_siniestro,582420,40,1646.78,0,1,0,0,0,0,0,1,0,0,0,0,0,0,0
Bajo,No_siniestro,582484,13,182.24,0,0,0,0,0,0,0,0,0,0,0,0,0,0,0
Bajo,No_siniestro,582616,191,71.78,0,0,0,0,0,0,0,0,0,0,0,0,0,0,0
Bajo,No_siniestro,583525,35,2118.2,0,0,0,0,0,0,0,0,0,0,0,0,0,0,0
Bajo,No_siniestro,586476,12,1300.12,0,0,0,0,0,0,0,0,0,0,0,0,0,0,0
Bajo,No_siniestro,586747,53,728.49,0,0,1,0,0,0,0,1,0,0,0,0,0,0,0
Bajo,No_siniestro,587290,40,0.03,0,0,0,0,0,0,0,0,0,0,0,0,0,0,0
Bajo,No_siniestro,588346,113,2258.52,0,0,0,0,0,0,0,0,0,0,0,0,0,0,0
Bajo,Si_siniestro,589779,10,1104.12,0,0,0,0,0,0,0,0,0,0,0,0,0,0,0
Bajo,No_siniestro,590198,111,1456.01,0,0,0,0,0,0,0,0,0,0,0,0,0,0,0
Bajo,No_siniestro,591849,6,806.82,0,0,0,0,1,1,0,2,0,0,0,0,0,0,0
Bajo,No_siniestro,592078,89,5328.34,0,0,0,0,0,0,0,0,0,0,0,0,0,0,0
Bajo,No_siniestro,592269,38,819.23,0,0,0,0,0,0,0,0,0,0,0,0,0,0,0
Bajo,No_siniestro,592760,40,246.2,0,0,0,0,0,0,0,0,0,0,0,0,0,0,0
Bajo,No_siniestro,593896,103,1325.45,0,0,0,0,0,0,0,0,0,0,0,0,0,0,0
Bajo,No_siniestro,594474,196,260.24,0,0,0,0,0,0,0,0,0,0,0,0,0,0,0
Bajo,No_siniestro,594695,133,1601.85,0,0,0,0,0,0,0,0,0,0,0,0,0,0,0
Bajo,No_siniestro,594749,24,287.42,0,0,0,0,0,0,0,0,0,0,0,0,0,0,0
Bajo,No_siniestro,595736,45,977.8,0,0,0,1,0,0,0,1,0,0,0,0,0,0,0
Bajo,No_siniestro,595875,14,546.06,0,0,0,0,0,0,0,0,0,0,0,0,0,0,0
Bajo,No_siniestro,595962,137,338.92,0,0,0,0,0,0,0,0,0,0,0,0,0,0,0
Bajo,No_siniestro,596003,91,7875.32,0,0,0,0,0,0,0,0,0,0,0,0,0,0,0
Bajo,No_siniestro,598180,40,600.32,0,0,0,0,0,0,0,0,0,0,0,0,0,0,0
Bajo,No_siniestro,598217,12,910.72,0,0,0,0,0,0,0,0,0,0,0,0,0,0,0
Bajo,No_siniestro,598451,10,852.23,0,0,0,0,0,0,0,0,0,0,0,0,0,0,0
Bajo,No_siniestro,599180,40,578.93,0,0,0,0,0,0,0,0,0,0,0,0,0,0,0
Bajo,No_siniestro,600168,12,2962.84,0,0,0,0,0,0,0,0,0,0,0,0,0,0,0
Bajo,No_siniestro,601523,91,796.47,0,0,0,0,0,0,0,0,0,0,0,0,0,0,0
Bajo,No_siniestro,601673,150,606.87,0,0,0,0,0,0,0,0,0,0,0,0,0,0,0
Bajo,No_siniestro,603837,36,139.98,0,0,0,0,0,0,0,0,0,0,0,0,0,0,0
Bajo,No_siniestro,605629,87,240.42,0,0,0,0,0,0,0,0,0,0,0,0,0,0,0
Bajo,No_siniestro,605922,24,346.08,0,0,0,1,0,0,0,1,0,0,0,0,0,0,0
Bajo,No_siniestro,606114,8,5729.68,0,0,0,0,0,0,0,0,0,0,0,0,0,0,0
Bajo,No_siniestro,606163,12,466.88,0,0,0,0,1,1,0,2,0,0,0,0,0,0,0
Bajo,No_siniestro,606568,34,89.31,0,0,0,0,0,0,0,0,0,0,0,0,0,0,0
Bajo,No_siniestro,606760,40,1757.19,0,0,0,0,0,0,0,0,0,0,0,0,0,0,0
Bajo,No_siniestro,607323,8,0.25,0,0,0,0,0,0,0,0,0,0,0,0,0,0,0
Bajo,No_siniestro,607363,31,2866.42,0,0,0,0,0,0,0,0,0,0,0,0,0,0,0
Bajo,No_siniestro,607776,122,1122.83,0,0,0,0,0,0,0,0,0,0,0,0,0,0,0
Bajo,No_siniestro,608087,6,3332.51,0,0,0,0,0,0,0,0,0,0,0,0,0,0,0
Bajo,No_siniestro,608875,8,775.59,0,0,0,0,0,0,0,0,0,0,0,0,0,0,0
Bajo,No_siniestro,609895,190,1828.09,0,0,0,0,0,0,1,1,0,0,0,0,0,0,0
Bajo,No_siniestro,610591,69,408.92,0,0,0,0,0,0,0,0,0,0,0,0,0,0,0
Bajo,No_siniestro,611057,33,71.67,0,0,0,0,0,0,0,0,0,0,0,0,0,0,0
Bajo,No_siniestro,612074,20,200.97,0,0,0,0,0,0,0,0,0,0,0,0,0,0,0
Bajo,No_siniestro,616121,6,1010.15,0,0,0,0,0,0,0,0,0,0,0,0,0,0,0
Bajo,No_siniestro,616142,24,10.36,0,0,0,0,0,0,0,0,0,0,0,0,0,0,0
Bajo,No_siniestro,617326,22,847.41,0,0,0,0,0,0,0,0,0,0,0,0,0,0,0
Bajo,No_siniestro,617390,40,522.85,0,0,0,0,0,0,0,0,0,0,0,0,0,0,0
Bajo,No_siniestro,617565,25,527.04,0,0,0,0,0,0,0,0,0,0,0,0,0,0,0
Bajo,No_siniestro,617796,40,887.72,0,0,0,0,0,0,0,0,0,0,0,0,0,0,0
Bajo,No_siniestro,619021,6,1878.75,0,0,0,0,0,0,0,0,0,0,0,0,0,0,0
Bajo,No_siniestro,619072,11,1109.68,0,0,0,0,0,0,0,0,0,0,0,0,0,0,0
Bajo,No_siniestro,619600,40,114.74,0,0,0,0,0,0,0,0,0,0,0,0,0,0,0
Bajo,No_siniestro,621093,7,0.02,0,0,0,0,0,0,0,0,0,0,0,0,0,0,0
Bajo,No_siniestro,621445,31,1808.95,0,0,0,0,0,0,1,1,0,0,0,0,0,0,0
Bajo,No_siniestro,621505,89,197.49,0,0,0,0,0,0,0,0,0,0,0,0,0,0,0
Bajo,No_siniestro,622840,40,1356.05,0,0,0,0,0,0,0,0,0,0,0,0,0,0,0
Bajo,No_siniestro,623612,12,0.33,0,0,0,0,0,0,0,0,0,0,0,0,0,0,0
Bajo,No_siniestro,624282,10,194.8,0,0,0,0,0,0,0,0,0,0,0,0,0,0,0
Bajo,No_siniestro,624501,51,123.87,0,0,0,0,0,0,0,0,0,0,0,0,0,0,0
Bajo,No_siniestro,624766,140,537.23,0,0,0,0,0,0,0,0,0,0,0,0,0,0,0
Bajo,Si_siniestro,626172,8,918.84,0,0,0,0,0,0,0,0,0,0,0,0,0,0,0
Bajo,No_siniestro,626214,6,1768.99,0,0,0,0,0,0,0,0,0,0,0,0,0,0,0
Bajo,No_siniestro,626324,6,84.03,0,0,0,0,0,0,0,0,0,0,0,0,0,0,0
Bajo,No_siniestro,628362,15,1828,0,0,0,1,0,0,0,1,0,0,0,0,0,0,0
Bajo,No_siniestro,628879,33,382.95,0,0,0,0,0,0,0,0,0,0,0,0,0,0,0
Bajo,No_siniestro,629533,56,442.74,0,0,0,0,0,0,0,0,0,0,0,0,0,0,0
Bajo,No_siniestro,629790,43,803.93,0,0,0,0,0,0,0,0,0,0,0,0,0,0,0
Bajo,No_siniestro,630696,18,1534.72,0,0,0,0,0,0,0,0,0,0,0,0,0,0,0
Bajo,No_siniestro,631231,49,15.64,0,0,0,0,0,0,0,0,0,0,0,0,0,0,0
Bajo,No_siniestro,631461,91,15.07,0,0,0,0,0,0,0,0,0,0,0,0,0,0,0
Bajo,No_siniestro,633064,18,319.35,0,0,0,0,0,0,0,0,0,0,0,0,0,0,0
Bajo,No_siniestro,633103,21,209.11,0,0,0,0,0,0,0,0,0,0,0,0,0,0,0
Bajo,No_siniestro,633557,18,16.65,0,0,0,0,0,0,0,0,0,0,0,0,0,0,0
Bajo,No_siniestro,633676,62,460.89,0,0,0,0,0,0,0,0,0,0,0,0,0,0,0
Bajo,No_siniestro,634522,48,6144.9,0,0,0,0,0,0,0,0,0,0,0,0,0,0,0
Bajo,No_siniestro,635427,23,3.09,0,0,0,0,0,0,0,0,0,0,0,0,0,0,0
Bajo,No_siniestro,635844,9,4260.89,0,0,0,0,0,0,0,0,0,0,0,0,0,0,0
Bajo,No_siniestro,635944,18,226.18,0,0,0,0,0,0,0,0,0,0,0,0,0,0,0
Bajo,No_siniestro,636776,40,690.32,0,0,0,0,0,0,0,0,0,0,0,0,0,0,0
Bajo,No_siniestro,637819,30,24,0,0,0,0,0,0,0,0,0,0,0,0,0,0,0
Bajo,No_siniestro,639208,8,1365.6,0,0,0,0,0,0,0,0,0,0,0,0,0,0,0
Bajo,No_siniestro,639756,32,746.03,0,0,0,0,0,0,0,0,0,0,0,0,0,0,0
Bajo,No_siniestro,640331,33,900.1,0,0,0,0,0,0,0,0,0,0,0,0,0,0,0
Bajo,No_siniestro,642293,29,747.13,0,0,0,0,0,0,0,0,0,0,0,0,0,0,0
Bajo,No_siniestro,643574,12,1390.84,0,0,0,0,0,0,0,0,0,0,0,0,0,0,0
Bajo,No_siniestro,644207,30,716.57,0,0,0,1,0,0,0,1,0,0,0,0,0,0,0
Bajo,No_siniestro,645486,15,469.82,0,0,0,0,0,0,0,0,0,0,0,0,0,0,0
Bajo,No_siniestro,645741,11,1851.9,0,0,0,0,0,0,0,0,0,0,0,0,0,0,0
Bajo,No_siniestro,645892,6,2147.89,15205.34,0,0,0,0,0,0,0,0,0,0,0,0,0,0
Bajo,No_siniestro,646213,18,2683.5,0,0,0,0,0,0,0,0,0,0,0,0,0,0,0
Bajo,No_siniestro,646478,99,234.94,0,0,0,0,0,0,0,0,0,0,0,0,0,0,0
Bajo,No_siniestro,646929,10,2897.33,0,0,0,0,0,0,0,0,0,0,0,0,0,0,0
Bajo,No_siniestro,647324,25,2454.3,0,1,1,1,0,0,0,3,0,0,0,0,0,0,0
Bajo,No_siniestro,647763,17,519.21,0,0,0,0,0,0,0,0,0,0,0,0,0,0,0
Bajo,No_siniestro,650732,93,830.79,0,0,1,0,0,0,0,1,0,0,0,0,0,0,0
Bajo,No_siniestro,650737,7,419.72,0,1,1,0,0,0,0,2,0,0,0,0,0,0,0
Bajo,No_siniestro,652928,165,151.74,0,0,0,0,0,0,0,0,0,0,0,0,0,0,0
Bajo,No_siniestro,653259,22,1038.78,0,0,0,0,0,0,0,0,0,0,0,0,0,0,0
Bajo,No_siniestro,655748,89,2032.46,0,0,0,0,0,0,0,0,0,0,0,0,0,0,0
Bajo,No_siniestro,657148,6,658.57,0,0,0,0,0,0,0,0,0,0,0,0,0,0,0
Bajo,No_siniestro,657194,68,1304.86,0,0,0,0,0,0,0,0,0,0,0,0,0,0,0
Bajo,No_siniestro,657515,7,2109.73,0,0,0,0,0,0,0,0,0,0,0,0,0,0,0
Bajo,No_siniestro,657659,27,2524.56,0,0,1,0,0,0,0,1,0,0,0,0,0,0,0
Bajo,No_siniestro,658135,125,171.98,0,0,0,0,0,0,0,0,0,0,0,0,0,0,0
Bajo,No_siniestro,658200,43,3630.32,0,0,0,0,0,0,0,0,0,0,0,0,0,0,0
Bajo,No_siniestro,660122,12,3949.98,0,0,0,0,0,0,0,0,0,0,0,0,0,0,0
Bajo,No_siniestro,660335,66,1046.3,0,0,0,0,0,0,0,0,0,0,0,0,0,0,0
Bajo,Si_siniestro,660919,32,20.51,0,0,1,0,1,1,0,3,0,0,0,0,0,0,0
Bajo,No_siniestro,661361,55,8935.58,0,0,0,0,0,0,0,0,0,0,0,0,0,0,0
Bajo,No_siniestro,662200,43,3883.85,0,0,0,0,0,0,0,0,0,0,0,0,0,0,0
Bajo,No_siniestro,662840,43,3865.35,0,0,0,0,0,0,0,0,0,0,0,0,0,0,0
Bajo,No_siniestro,664322,130,1030.59,0,0,0,0,0,0,0,0,0,0,0,0,0,0,0
Bajo,No_siniestro,665847,35,1691.46,0,0,0,0,0,0,0,0,0,0,0,0,0,0,0
Bajo,No_siniestro,667336,31,3436.18,0,1,0,0,0,0,0,1,0,0,0,0,0,0,0
Bajo,No_siniestro,667613,66,151,0,0,0,0,0,0,0,0,0,0,0,0,0,0,0
Bajo,No_siniestro,667969,150,1874.65,0,0,0,0,0,0,0,0,0,0,0,0,0,0,0
Bajo,No_siniestro,668021,154,2114.55,0,0,0,0,0,0,0,0,0,0,0,0,0,0,0
Bajo,No_siniestro,668192,7,866.06,0,0,0,0,0,0,0,0,0,0,0,0,0,0,0
Bajo,No_siniestro,670926,172,907.96,0,0,0,0,0,0,0,0,0,0,0,0,0,0,0
Bajo,No_siniestro,673990,43,680.23,0,0,0,0,0,0,0,0,0,0,0,0,0,0,0
Bajo,No_siniestro,674016,8,8333.84,0,0,0,0,0,0,0,0,0,0,0,0,0,0,0
Bajo,No_siniestro,675101,18,900.16,0,0,0,0,0,0,0,0,0,0,0,0,0,0,0
Bajo,No_siniestro,675419,6,0.02,0,0,0,0,0,0,0,0,0,0,0,0,0,0,0
Bajo,No_siniestro,675532,95,10.78,0,0,0,0,0,0,0,0,0,0,0,0,0,0,0
Bajo,No_siniestro,676398,30,2432.06,0,0,0,0,0,0,0,0,0,0,0,0,0,0,0
Bajo,No_siniestro,676718,20,579.48,0,0,0,0,0,0,0,0,0,0,0,0,0,0,0
Bajo,No_siniestro,681512,100,8975.58,0,0,0,0,0,0,0,0,0,0,0,0,0,0,0
Bajo,No_siniestro,682749,63,3786.21,0,0,0,0,0,0,0,0,0,0,0,0,0,0,0
Bajo,No_siniestro,683047,13,1575.69,0,0,0,0,0,0,0,0,0,0,0,0,0,0,0
Bajo,No_siniestro,683452,8,1191.28,0,0,0,0,0,0,0,0,0,0,0,0,0,0,0
Bajo,No_siniestro,683636,59,398.46,0,0,0,0,0,0,0,0,0,0,0,0,0,0,0
Bajo,No_siniestro,683794,18,58.36,0,0,0,0,0,0,0,0,0,0,0,0,0,0,0
Bajo,No_siniestro,683933,149,2317.06,0,0,0,0,0,0,0,0,0,0,0,0,0,0,0
Bajo,No_siniestro,686031,9,870.56,0,0,0,0,0,0,0,0,0,0,0,0,0,0,0
Bajo,No_siniestro,687670,43,464.14,0,0,0,0,0,0,0,0,0,0,0,0,0,0,0
Bajo,No_siniestro,688122,37,1399.45,0,0,0,0,0,0,0,0,0,0,0,0,0,0,0
Bajo,No_siniestro,688131,21,120.96,0,0,0,0,0,0,0,0,0,0,0,0,0,0,0
Bajo,No_siniestro,688918,6,991.52,0,0,0,0,0,0,0,0,0,0,0,0,0,0,0
Bajo,No_siniestro,690089,27,1403.22,0,0,0,0,0,0,0,0,0,0,0,0,0,0,0
Bajo,Si_siniestro,693495,13,1086.93,0,0,0,0,0,0,0,0,0,0,0,0,0,0,0
Bajo,No_siniestro,695423,6,46.62,0,0,0,0,0,0,0,0,0,0,0,0,0,0,0
Bajo,No_siniestro,695794,23,420.62,0,0,0,0,0,0,0,0,0,0,0,0,0,0,0
Bajo,No_siniestro,696115,67,0.18,0,0,0,0,0,0,0,0,0,0,0,0,0,0,0
Bajo,No_siniestro,696686,53,31.28,0,0,0,0,0,0,0,0,0,0,0,0,0,0,0
Bajo,No_siniestro,697261,36,2615.28,0,0,0,0,0,0,0,0,0,0,0,0,0,0,0
Bajo,No_siniestro,699040,43,53.34,0,0,0,0,0,0,0,0,0,0,0,0,0,0,0
Bajo,No_siniestro,699831,8,122.76,0,0,0,0,0,0,0,0,0,0,0,0,0,0,0
Bajo,No_siniestro,699847,13,493.2,0,0,0,0,0,0,0,0,0,0,0,0,0,0,0
Bajo,No_siniestro,700374,6,2425.37,0,0,0,0,0,0,0,0,0,0,0,0,0,0,0
Bajo,No_siniestro,701015,57,705.43,0,0,0,0,0,0,0,0,0,0,0,0,0,0,0
Bajo,No_siniestro,701389,11,224.05,0,0,0,0,0,0,0,0,0,0,0,0,0,0,0
Bajo,No_siniestro,703026,30,1256.68,0,0,0,0,0,0,0,0,0,0,0,0,0,0,0
Bajo,No_siniestro,703350,43,222.55,0,0,0,0,0,0,0,0,0,0,0,0,0,0,0
Bajo,No_siniestro,704464,7,533.31,0,0,0,0,0,0,0,0,0,0,0,0,0,0,0
Bajo,No_siniestro,705882,90,254.46,0,0,0,0,0,0,0,0,0,0,0,0,0,0,0
Bajo,No_siniestro,706046,12,1103.14,0,0,0,0,0,0,0,0,0,0,0,0,0,0,0
Bajo,No_siniestro,707494,17,1474.83,0,0,0,0,0,0,0,0,0,0,0,0,0,0,0
Bajo,No_siniestro,707722,9,3659.83,0,0,0,0,0,0,0,0,0,0,0,0,0,0,0
Bajo,No_siniestro,708143,9,308.23,0,0,0,0,0,0,0,0,0,0,0,0,0,0,0
Bajo,No_siniestro,709176,14,0.05,0,0,0,0,0,0,0,0,0,0,0,0,0,0,0
Bajo,No_siniestro,709566,19,936.44,0,0,0,0,0,0,0,0,0,0,0,0,0,0,0
Bajo,No_siniestro,710663,9,3127.37,0,0,0,0,0,0,0,0,0,0,0,0,0,0,0
Bajo,No_siniestro,710896,8,1525.26,0,0,0,0,0,0,0,0,0,0,0,0,0,0,0
Bajo,No_siniestro,710958,19,706.51,0,0,0,0,0,0,0,0,0,0,0,0,0,0,0
Bajo,No_siniestro,712061,13,1383.53,0,0,0,0,0,0,0,0,0,0,0,0,0,0,0
Bajo,Si_siniestro,712206,13,2191.2,0,1,1,1,1,0,0,4,0,0,0,0,0,0,0
Bajo,No_siniestro,712376,14,16.14,0,0,0,3,2,2,1,8,0,0,0,0,0,0,0
Bajo,No_siniestro,712465,10,242.46,0,0,0,0,0,0,0,0,0,0,0,0,0,0,0
Bajo,No_siniestro,713694,9,185.31,0,0,0,0,0,0,0,0,0,0,0,0,0,0,0
Bajo,No_siniestro,713786,14,0.77,0,0,0,0,0,0,0,0,0,0,0,0,0,0,0
Bajo,No_siniestro,714842,6,95.28,0,0,0,0,0,1,0,1,0,0,0,0,0,0,0
Bajo,Si_siniestro,715386,6,860.48,0,0,1,0,0,0,0,1,0,0,0,0,0,0,0
Bajo,No_siniestro,715842,9,283.56,0,0,0,0,0,0,0,0,0,0,0,0,0,0,0
Bajo,No_siniestro,716346,21,1045.8,0,0,0,0,0,0,0,0,0,0,0,0,0,0,0
Bajo,No_siniestro,717495,57,1671.52,0,0,0,0,0,0,0,0,0,0,0,0,0,0,0
Bajo,Si_siniestro,718387,7,855.92,0,0,0,1,0,0,0,1,0,0,0,0,0,0,0
Bajo,No_siniestro,719721,6,23.84,0,0,0,1,1,1,1,4,0,0,0,0,0,0,0
Bajo,No_siniestro,720579,80,45.41,0,0,0,0,0,0,0,0,0,0,0,0,0,0,0
Bajo,No_siniestro,720983,95,88.7,0,0,0,0,0,0,0,0,0,0,0,0,0,0,0
Bajo,Si_siniestro,721709,7,1892.38,0,0,0,0,0,0,0,0,0,0,0,0,0,0,0
Bajo,No_siniestro,722370,43,11920.54,0,0,0,0,0,0,0,0,0,0,0,0,0,0,0
Bajo,No_siniestro,723202,54,1274.81,0,0,0,0,0,1,0,1,0,0,0,0,0,0,0
Bajo,No_siniestro,723385,66,766.71,0,0,0,0,0,1,0,1,0,0,0,0,0,0,0
Bajo,No_siniestro,723398,50,692.46,0,0,0,0,0,0,0,0,0,0,0,0,0,0,0
Bajo,No_siniestro,723974,175,3178.74,0,0,0,0,0,1,1,2,0,0,0,0,0,0,0
Bajo,No_siniestro,724326,67,479.16,0,0,0,0,0,0,0,0,0,0,0,0,0,0,0
Bajo,No_siniestro,726715,10,5288.32,0,0,0,0,0,0,0,0,0,0,0,0,0,0,0
Bajo,No_siniestro,727625,7,1174.61,0,0,0,0,0,0,0,0,0,0,0,0,0,0,0
Bajo,No_siniestro,727787,20,1113.13,0,0,0,0,0,0,0,0,0,0,0,0,0,0,0
Bajo,No_siniestro,728814,102,459.1,0,0,0,0,0,0,0,0,0,0,0,0,0,0,0
Bajo,No_siniestro,729243,9,2180.52,0,0,0,0,0,0,0,0,0,0,0,0,0,0,0
Bajo,No_siniestro,729394,11,530.07,0,0,0,0,0,0,0,0,0,0,0,0,0,0,0
Bajo,No_siniestro,729811,6,959.18,0,0,0,0,0,0,0,0,0,0,0,0,0,0,0
Bajo,No_siniestro,729851,130,3013.57,0,0,0,0,0,0,0,0,0,0,0,0,0,0,0
Bajo,No_siniestro,730588,198,1226.02,0,0,0,0,0,0,0,0,0,0,0,0,0,0,0
Bajo,No_siniestro,730702,39,27.26,0,0,0,0,0,0,0,0,0,0,0,0,0,0,0
Bajo,No_siniestro,730867,55,2305.97,0,0,0,0,0,0,0,0,0,0,0,0,0,0,0
Bajo,No_siniestro,730997,21,4593.8,0,0,0,0,0,0,0,0,0,0,0,0,0,0,0
Bajo,No_siniestro,731123,8,1235.7,0,0,0,0,0,0,0,0,0,0,0,0,0,0,0
Bajo,No_siniestro,731587,15,2006.08,0,0,0,0,0,0,0,0,0,0,0,0,0,0,0
Bajo,No_siniestro,733914,55,1185.84,0,0,0,0,0,0,0,0,0,0,0,0,0,0,0
Bajo,No_siniestro,735257,30,0.26,0,3,2,1,0,0,0,6,0,0,0,0,0,0,0
Bajo,No_siniestro,735963,21,18.44,0,0,0,0,0,0,0,0,0,0,0,0,0,0,0
Bajo,No_siniestro,735966,34,135.39,0,0,0,0,0,0,0,0,0,0,0,0,0,0,0
Bajo,No_siniestro,736047,187,2549.94,0,0,0,0,0,0,0,0,0,0,0,0,0,0,0
Bajo,No_siniestro,736139,11,781.46,0,0,0,0,0,0,0,0,0,0,0,0,0,0,0
Bajo,No_siniestro,736923,141,390.69,0,0,0,0,0,0,0,0,0,0,0,0,0,0,0
Bajo,No_siniestro,736937,27,323.33,0,1,0,1,0,0,0,2,0,0,0,0,0,0,0
Bajo,No_siniestro,738759,11,2356.72,0,1,0,0,1,0,0,2,0,0,0,0,0,0,0
Bajo,No_siniestro,740971,26,430.25,0,0,0,0,0,0,0,0,0,0,0,0,0,0,0
Bajo,No_siniestro,741101,26,1290.97,0,0,0,0,0,0,0,0,0,0,0,0,0,0,0
Bajo,No_siniestro,741131,7,428.39,0,0,0,1,0,0,0,1,0,0,0,0,0,0,0
Bajo,No_siniestro,741551,58,61.32,0,0,0,1,0,0,0,1,0,0,0,0,0,0,0
Bajo,No_siniestro,744977,81,0.01,0,0,0,0,0,0,0,0,0,0,0,0,0,0,0
Bajo,No_siniestro,745445,11,193.02,0,0,0,0,0,0,0,0,0,0,0,0,0,0,0
Bajo,No_siniestro,748048,9,656.83,0,0,0,0,0,0,0,0,0,0,0,0,0,0,0
Bajo,No_siniestro,749375,16,867.31,0,0,0,0,0,0,0,0,0,0,0,0,0,0,0
Bajo,No_siniestro,749453,9,1125.18,0,0,0,0,0,0,0,0,0,0,0,0,0,0,0
Bajo,No_siniestro,749809,10,698.86,0,0,0,0,0,0,0,0,0,0,0,0,0,0,0
Bajo,No_siniestro,749869,15,346.91,0,0,0,0,0,0,0,0,0,0,0,0,0,0,0
Bajo,No_siniestro,753033,59,1279.47,0,0,0,0,0,0,0,0,0,0,0,0,0,0,0
Bajo,No_siniestro,753544,7,711.57,0,0,0,0,0,0,0,0,0,0,0,0,0,0,0
Bajo,Si_siniestro,754497,14,340.92,0,3,2,1,0,0,0,6,0,0,0,0,0,0,0
Bajo,No_siniestro,754781,13,435.69,0,0,0,0,0,0,0,0,0,0,0,0,0,0,0
Bajo,No_siniestro,755027,16,780.3,0,0,0,0,0,0,0,0,0,0,0,0,0,0,0
Bajo,No_siniestro,757294,17,8465.2,0,1,1,0,0,0,0,2,0,0,0,0,0,0,0
Bajo,No_siniestro,758514,165,118.09,0,0,0,1,0,0,0,1,0,0,0,0,0,0,0
Bajo,No_siniestro,759507,18,3567.18,0,0,0,0,0,0,0,0,0,0,0,0,0,0,0
Bajo,No_siniestro,759692,10,2159.28,0,0,0,1,0,0,0,1,0,0,0,0,0,0,0
Bajo,No_siniestro,763089,99,996.95,0,0,0,0,0,0,0,0,0,0,0,0,0,0,0
Bajo,No_siniestro,764448,9,24.31,0,0,0,0,0,0,0,0,0,0,0,0,0,0,0
Bajo,No_siniestro,766708,34,3377.38,0,0,0,0,0,0,0,0,0,0,0,0,0,0,0
Bajo,No_siniestro,766925,33,1143.66,0,0,0,0,0,0,0,0,0,0,0,0,0,0,0
Bajo,No_siniestro,767733,48,10.61,0,0,0,0,0,0,0,0,0,0,0,0,0,0,0
Bajo,No_siniestro,767813,11,2766.42,0,0,0,0,0,0,0,0,0,0,0,0,0,0,0
Bajo,No_siniestro,767903,55,59.55,0,0,0,0,0,0,0,0,0,0,0,0,0,0,0
Bajo,No_siniestro,767939,20,416.57,0,0,0,0,0,0,0,0,0,0,0,0,0,0,0
Bajo,No_siniestro,768120,43,205.77,0,0,0,0,0,0,0,0,0,0,0,0,0,0,0
Bajo,No_siniestro,768413,118,346.22,0,0,0,0,0,0,0,0,0,0,0,0,0,0,0
Bajo,No_siniestro,770320,43,940.51,0,0,0,0,0,0,1,1,0,0,0,0,0,0,0
Bajo,No_siniestro,772350,43,2334.87,0,0,0,0,0,0,0,0,0,0,0,0,0,0,0
Bajo,No_siniestro,772484,17,1646.33,0,0,0,1,0,0,0,1,0,0,0,0,0,0,0
Bajo,No_siniestro,773958,7,566.84,0,0,0,0,0,0,0,0,0,0,0,0,0,0,0
Bajo,No_siniestro,774601,6,1019.57,0,0,0,0,0,0,0,0,0,0,0,0,0,0,0
Bajo,No_siniestro,776384,10,734.43,0,0,0,0,0,0,0,0,0,0,0,0,0,0,0
Bajo,No_siniestro,776645,85,889.14,0,0,0,0,0,0,0,0,0,0,0,0,0,0,0
Bajo,No_siniestro,777359,51,0.04,0,0,0,0,0,0,0,0,0,0,0,0,0,0,0
Bajo,No_siniestro,779394,31,0.01,0,0,0,0,0,0,0,0,0,0,0,0,0,0,0
Bajo,No_siniestro,779966,70,259.18,0,1,0,1,0,0,0,2,0,0,0,0,0,0,0
Bajo,No_siniestro,780476,23,1798.04,0,0,0,0,0,0,0,0,0,0,0,0,0,0,0
Bajo,No_siniestro,780658,20,9413.98,0,0,0,0,0,0,0,0,0,0,0,0,0,0,0
Bajo,No_siniestro,781303,11,1661.99,0,0,1,0,1,0,1,3,0,0,0,0,0,0,0
Bajo,No_siniestro,781596,8,1339.72,0,0,0,0,0,0,0,0,0,0,0,0,0,0,0
Bajo,No_siniestro,782393,6,2686.79,0,0,0,0,0,0,0,0,0,0,0,0,0,0,0
Bajo,No_siniestro,782519,7,155.43,0,0,0,0,0,0,0,0,0,0,0,0,0,0,0
Bajo,No_siniestro,782750,43,68.79,0,0,0,0,0,0,0,0,0,0,0,0,0,0,0
Bajo,No_siniestro,783901,6,299.28,0,0,1,0,0,0,0,1,0,0,0,0,0,0,0
Bajo,No_siniestro,785234,23,933.57,0,0,0,0,0,0,0,0,0,0,0,0,0,0,0
Bajo,No_siniestro,785257,10,0.03,0,0,0,0,0,0,1,1,0,0,0,0,0,0,0
Bajo,No_siniestro,785403,11,333.5,0,0,0,0,0,0,0,0,0,0,0,0,0,0,0
Bajo,Si_siniestro,786085,12,1432.87,0,0,0,0,0,0,0,0,0,0,0,0,0,0,0
Bajo,No_siniestro,788134,25,590.73,0,0,0,0,0,0,0,0,0,0,0,0,0,0,0
Bajo,No_siniestro,788138,9,2803.77,0,1,1,1,1,1,0,5,0,0,0,0,0,0,0
Bajo,No_siniestro,788451,7,1429.3,0,0,0,0,0,0,0,0,0,0,0,0,0,0,0
Bajo,No_siniestro,788463,6,1602.11,0,0,0,0,0,0,0,0,0,0,0,0,0,0,0
Bajo,No_siniestro,5973,45,1356.88,0,1,1,1,1,1,1,6,0,0,0,0,0,0,0
Bajo,No_siniestro,7878,5,1221,0,0,0,0,0,0,0,0,0,0,0,0,0,0,0
Bajo,No_siniestro,9966,102,0,0,0,0,0,0,0,0,0,0,0,0,0,0,0,0
Bajo,No_siniestro,16614,0,101.87,0,0,0,0,0,0,0,0,0,0,0,0,0,0,0
Bajo,No_siniestro,16642,0,635.77,0,0,0,0,0,0,0,0,0,0,0,0,0,0,0
Bajo,No_siniestro,20837,0,2345.43,0,0,0,0,0,0,0,0,0,0,0,0,0,0,0
Bajo,No_siniestro,38810,43,0,0,0,0,0,0,0,0,0,0,0,0,0,0,0,0
Bajo,No_siniestro,39150,43,0,0,0,0,0,0,0,0,0,0,0,0,0,0,0,0
Bajo,No_siniestro,40927,74,0,0,0,0,0,0,0,0,0,0,0,0,0,0,0,0
Bajo,No_siniestro,45094,5,255.24,0,0,0,0,0,0,0,0,0,0,0,0,0,0,0
Bajo,No_siniestro,45274,1,0.22,0,0,0,0,0,0,0,0,0,0,0,0,0,0,0
Bajo,No_siniestro,50933,2,81.33,0,0,0,0,0,0,0,0,0,0,0,0,0,0,0
Bajo,No_siniestro,55805,0,45.59,0,0,0,0,0,0,0,0,0,0,0,0,0,0,0
Bajo,No_siniestro,57083,2,2174.64,0,0,0,0,0,0,0,0,0,0,0,0,0,0,0
Bajo,No_siniestro,66914,0,377.8,0,0,0,0,0,0,0,0,0,0,0,0,0,0,0
Bajo,No_siniestro,67845,87,0,5427.97,0,0,0,0,0,0,0,0,0,0,0,0,0,0
Bajo,No_siniestro,71979,3,245.73,0,0,0,0,0,0,0,0,0,0,0,0,0,0,0
Bajo,No_siniestro,72380,42,1943.35,0,0,0,0,0,0,0,0,0,0,0,0,0,0,0
Bajo,No_siniestro,75160,42,0,0,0,0,0,0,0,0,0,0,0,0,0,0,0,0
Bajo,No_siniestro,75895,60,7.68,0,0,0,0,0,0,0,0,0,0,0,0,0,0,0
Bajo,No_siniestro,93765,34,0,0,0,0,0,0,0,0,0,0,0,0,0,0,0,0
Bajo,No_siniestro,97765,53,2597.25,0,0,0,0,0,0,0,0,0,0,0,0,0,0,0
Bajo,No_siniestro,102947,6,788.17,0,0,0,0,1,1,0,2,0,0,0,0,0,0,0
Bajo,No_siniestro,105640,42,0,0,0,0,0,0,0,0,0,0,0,0,0,0,0,0
Bajo,No_siniestro,108018,0,491.28,0,0,0,0,0,0,0,0,0,0,0,0,0,0,0
Bajo,No_siniestro,110877,3,971.63,0,0,0,0,0,0,0,0,0,0,0,0,0,0,0
Bajo,No_siniestro,113931,1,966.17,0,0,0,0,0,0,0,0,0,0,0,0,0,0,0
Bajo,No_siniestro,114453,10,74.96,0,0,0,0,0,0,0,0,0,0,0,0,0,0,0
Bajo,No_siniestro,118634,39,0,0,0,0,0,0,0,0,0,0,0,0,0,0,0,0
Bajo,No_siniestro,119816,0,1705.7,0,0,0,0,0,0,0,0,0,0,0,0,0,0,0
Bajo,No_siniestro,120667,42,2022.91,0,0,0,0,0,0,0,0,0,0,0,0,0,0,0
Bajo,No_siniestro,122239,12,2237.76,0,0,0,0,0,0,0,0,0,0,0,0,0,0,0
Bajo,No_siniestro,126717,1,520.75,0,0,0,0,0,0,0,0,0,0,0,0,0,0,0
Bajo,No_siniestro,128360,42,0,0,0,0,0,0,0,0,0,0,0,0,0,0,0,0
Bajo,No_siniestro,129418,2,138.76,0,0,0,0,0,0,0,0,0,0,0,0,0,0,0
Bajo,No_siniestro,134536,47,0,0,0,0,0,0,0,0,0,0,0,0,0,0,0,0
Bajo,No_siniestro,138097,3,2011.95,0,0,0,0,0,0,0,0,0,0,0,0,0,0,0
Bajo,No_siniestro,138817,11,527.01,0,0,0,0,0,0,0,0,0,0,0,0,0,0,0
Bajo,No_siniestro,139387,53,756.04,0,0,0,0,0,0,0,0,0,0,0,0,0,0,0
Bajo,No_siniestro,145197,5,1774.09,0,0,0,0,0,0,0,0,0,0,0,0,0,0,0
Bajo,No_siniestro,145699,73,0,0,0,0,0,0,0,0,0,0,0,0,0,0,0,0
Bajo,No_siniestro,145859,5,705.16,0,0,0,0,0,0,0,0,0,0,0,0,0,0,0
Bajo,No_siniestro,146025,1,0,0,0,0,0,0,0,0,0,0,0,0,0,0,0,0
Bajo,No_siniestro,154937,4,21.59,0,0,0,0,0,0,0,0,0,0,0,0,0,0,0
Bajo,No_siniestro,155584,119,92.07,0,0,0,0,0,0,0,0,0,0,0,0,0,0,0
Bajo,No_siniestro,156278,0,423.01,0,0,0,0,0,0,0,0,0,0,0,0,0,0,0
Bajo,No_siniestro,160371,27,0,0,0,0,0,0,0,0,0,0,0,0,0,0,0,0
Bajo,No_siniestro,162586,5,326.12,0,0,0,0,0,0,0,0,0,0,0,0,0,0,0
Bajo,No_siniestro,164937,6,295.01,0,0,0,0,0,0,0,0,0,0,0,0,0,0,0
Bajo,No_siniestro,166600,42,54.82,0,0,0,0,0,0,0,0,0,0,0,0,0,0,0
Bajo,No_siniestro,167281,102,797.65,0,1,0,0,0,0,0,1,0,0,0,0,0,0,0
Bajo,No_siniestro,168968,0,159.21,0,0,0,0,0,0,0,0,0,0,0,0,0,0,0
Bajo,No_siniestro,170530,42,1649.79,0,0,0,0,0,0,0,0,0,0,0,0,0,0,0
Bajo,No_siniestro,182193,2,1335.15,0,0,0,0,0,0,0,0,0,0,0,0,0,0,0
Bajo,No_siniestro,184314,3,0,0,0,0,0,0,0,0,0,0,0,0,0,0,0,0
Bajo,No_siniestro,186065,71,0,0,0,0,0,0,0,0,0,0,0,0,0,0,0,0
Bajo,No_siniestro,187252,1,1119.44,0,0,0,0,0,0,0,0,0,0,0,0,0,0,0
Bajo,No_siniestro,189701,0,0,0,0,0,0,0,0,0,0,0,0,0,0,0,0,0
Bajo,No_siniestro,193093,4,78.61,0,0,0,0,0,0,0,0,0,0,0,0,0,0,0
Bajo,No_siniestro,195986,0,1232.84,0,0,0,0,0,0,0,0,0,0,0,0,0,0,0
Bajo,No_siniestro,198477,108,0,0,0,0,0,0,0,0,0,0,0,0,0,0,0,0
Bajo,No_siniestro,202188,6,1546.63,0,0,0,0,0,0,0,0,0,0,0,0,0,0,0
Bajo,No_siniestro,204686,27,0,0,0,0,0,0,0,0,0,0,0,0,0,0,0,0
Bajo,No_siniestro,212080,42,498.15,0,0,0,0,0,0,0,0,0,0,0,0,0,0,0
Bajo,No_siniestro,219893,69,639.52,0,0,0,0,0,0,0,0,0,0,0,0,0,0,0
Bajo,No_siniestro,221207,7,537.85,0,0,0,0,0,0,0,0,0,0,0,0,0,0,0
Bajo,No_siniestro,228739,1,333.61,0,0,0,0,0,0,0,0,0,0,0,0,0,0,0
Bajo,No_siniestro,234109,1,1652.64,0,0,0,0,0,0,0,0,0,0,0,0,0,0,0
Bajo,No_siniestro,239910,42,2277.51,0,0,0,0,0,0,0,0,0,0,0,0,0,0,0
Bajo,No_siniestro,241405,65,0,0,0,0,0,0,0,0,0,0,0,0,0,0,0,0
Bajo,No_siniestro,242352,5,224.91,0,0,0,0,0,0,0,0,0,0,0,0,0,0,0
Bajo,No_siniestro,243387,23,501.57,0,0,0,0,0,0,0,0,0,0,0,0,0,0,0
Bajo,No_siniestro,249108,2,53.62,0,0,0,0,0,0,0,0,0,0,0,0,0,0,0
Bajo,No_siniestro,250725,1,20.03,0,0,0,0,0,0,0,0,0,0,0,0,0,0,0
Bajo,No_siniestro,250772,2,1105.54,0,0,0,0,0,0,0,0,0,0,0,0,0,0,0
Bajo,No_siniestro,255846,3,317.19,0,0,0,0,0,0,0,0,0,0,0,0,0,0,0
Bajo,No_siniestro,257190,42,2201.61,0,0,0,0,0,0,0,0,0,0,0,0,0,0,0
Bajo,No_siniestro,260887,3,3003.3,0,0,0,0,0,0,0,0,0,0,0,0,0,0,0
Bajo,No_siniestro,263775,4,701.15,0,0,0,0,0,0,0,0,0,0,0,0,0,0,0
Bajo,No_siniestro,266586,3,159.31,0,0,0,0,0,0,0,0,0,0,0,0,0,0,0
Bajo,No_siniestro,266905,90,0,0,0,0,0,0,0,0,0,0,0,0,0,0,0,0
Bajo,No_siniestro,268008,5,288.13,0,0,0,0,0,1,0,1,0,0,0,0,0,0,0
Bajo,No_siniestro,274289,62,0,0,0,0,0,0,0,0,0,0,0,0,0,0,0,0
Bajo,No_siniestro,275921,2,466.92,0,0,0,0,0,0,0,0,0,0,0,0,0,0,0
Bajo,No_siniestro,275935,1,1275.79,0,0,0,0,0,0,0,0,0,0,0,0,0,0,0
Bajo,No_siniestro,277572,5,576.16,0,0,0,0,0,0,0,0,0,0,0,0,0,0,0
Bajo,No_siniestro,281579,0,631.59,0,0,0,0,0,0,0,0,0,0,0,0,0,0,0
Bajo,No_siniestro,286627,22,0,0,0,0,0,0,0,0,0,0,0,0,0,0,0,0
Bajo,No_siniestro,287652,24,63.19,0,0,0,0,0,0,0,0,0,0,0,0,0,0,0
Bajo,No_siniestro,290461,4,3693.57,0,0,0,0,0,0,0,0,0,0,0,0,0,0,0
Bajo,No_siniestro,291918,8,0,0,0,0,0,0,0,0,0,0,0,0,0,0,0,0
Bajo,No_siniestro,294363,7,0,0,0,0,0,0,0,0,0,0,0,0,0,0,0,0
Bajo,No_siniestro,301314,0,1144.82,0,0,0,0,0,0,0,0,0,0,0,0,0,0,0
Bajo,No_siniestro,304887,17,486.18,0,0,0,0,0,1,0,1,0,0,0,0,0,0,0
Bajo,No_siniestro,306171,4,255.54,0,0,0,1,0,0,0,1,0,0,0,0,0,0,0
Bajo,No_siniestro,307289,2,1138.15,0,0,0,0,0,0,0,0,0,0,0,0,0,0,0
Bajo,No_siniestro,311855,21,479.88,0,0,0,0,0,0,0,0,0,0,0,0,0,0,0
Bajo,No_siniestro,311889,7,829.82,0,1,0,0,1,1,1,4,0,0,0,0,0,0,0
Bajo,No_siniestro,312777,1,1579.05,0,0,0,0,0,0,0,0,0,0,0,0,0,0,0
Bajo,No_siniestro,317100,42,579.17,0,0,0,0,0,0,0,0,0,0,0,0,0,0,0
Bajo,No_siniestro,322611,9,16.46,0,1,0,0,0,0,0,1,0,0,0,0,0,0,0
Bajo,No_siniestro,323000,42,1496.2,0,0,0,0,0,0,0,0,0,0,0,0,0,0,0
Bajo,No_siniestro,327382,5,285.39,0,0,0,0,0,0,0,0,0,0,0,0,0,0,0
Bajo,No_siniestro,327528,3,72.14,0,0,0,0,0,0,0,0,0,0,0,0,0,0,0
Bajo,No_siniestro,329412,51,0,0,0,0,0,0,0,0,0,0,0,0,0,0,0,0
Bajo,No_siniestro,332901,9,425.85,0,0,0,0,0,0,0,0,0,0,0,0,0,0,0
Bajo,No_siniestro,332915,199,0,0,0,0,0,0,0,0,0,0,0,0,0,0,0,0
Bajo,No_siniestro,335727,3,682.35,0,0,0,0,0,0,0,0,0,0,0,0,0,0,0
Bajo,No_siniestro,338826,5,48.17,0,0,0,0,0,0,0,0,0,0,0,0,0,0,0
Bajo,No_siniestro,340976,37,0,0,0,0,0,0,0,0,0,0,0,0,0,0,0,0
Bajo,No_siniestro,342076,0,755.03,0,0,0,0,0,0,0,0,0,0,0,0,0,0,0
Bajo,No_siniestro,348403,1,2146.65,0,0,0,0,0,0,0,0,0,0,0,0,0,0,0
Bajo,No_siniestro,349351,14,163.76,0,0,0,0,0,0,0,0,0,0,0,0,0,0,0
Bajo,No_siniestro,353316,54,1388.2,0,0,0,0,0,0,0,0,0,0,0,0,0,0,0
Bajo,No_siniestro,354174,1,0,0,0,0,0,0,0,0,0,0,0,0,0,0,0,0
Bajo,No_siniestro,356929,3,1250.97,0,0,0,0,0,0,0,0,0,0,0,0,0,0,0
Bajo,No_siniestro,358069,16,470.23,0,0,0,0,0,0,0,0,0,0,0,0,0,0,0
Bajo,No_siniestro,358941,0,0,0,0,0,0,0,0,0,0,0,0,0,0,0,0,0
Bajo,No_siniestro,362779,0,138.13,0,0,0,0,0,0,0,0,0,0,0,0,0,0,0
Bajo,No_siniestro,366650,42,0,0,0,0,0,0,0,0,0,0,0,0,0,0,0,0
Bajo,No_siniestro,367408,3,144.27,0,0,0,0,0,0,0,0,0,0,0,0,0,0,0
Bajo,No_siniestro,368054,11,1317,0,0,0,0,0,0,0,0,0,0,0,0,0,0,0
Bajo,No_siniestro,369438,44,166.79,0,0,0,0,0,0,0,0,0,0,0,0,0,0,0
Bajo,No_siniestro,370323,1,239.96,0,0,0,0,0,0,0,0,0,0,0,0,0,0,0
Bajo,No_siniestro,372132,1,2298.07,0,0,0,0,0,0,0,0,0,0,0,0,0,0,0
Bajo,No_siniestro,372373,0,0,0,0,0,0,0,0,0,0,0,0,0,0,0,0,0
Bajo,No_siniestro,376292,4,1976,0,0,0,0,0,0,0,0,0,0,0,0,0,0,0
Bajo,No_siniestro,376873,1,0,0,0,0,0,0,0,0,0,0,0,0,0,0,0,0
Bajo,No_siniestro,377108,3,0,0,0,0,0,0,0,0,0,0,0,0,0,0,0,0
Bajo,No_siniestro,377571,2,446.3,0,0,0,0,0,0,0,0,0,0,0,0,0,0,0
Bajo,No_siniestro,380190,42,28.92,0,0,0,0,0,0,0,0,0,0,0,0,0,0,0
Bajo,No_siniestro,381090,42,1792.6,0,0,0,0,0,0,0,0,0,0,0,0,0,0,0
Bajo,No_siniestro,389467,18,2170.31,0,0,0,0,0,0,0,0,0,0,0,0,0,0,0
Bajo,No_siniestro,391410,42,0,0,0,0,0,0,0,0,0,0,0,0,0,0,0,0
Bajo,No_siniestro,392068,8,2325.12,0,0,1,1,1,0,1,4,0,0,0,0,0,0,0
Bajo,No_siniestro,392425,1,1161.34,0,0,0,0,0,0,0,0,0,0,0,0,0,0,0
Bajo,No_siniestro,393242,7,151.8,0,0,0,0,0,0,0,0,0,0,0,0,0,0,0
Bajo,No_siniestro,396022,43,0,0,0,0,0,0,0,0,0,0,0,0,0,0,0,0
Bajo,No_siniestro,402913,5,2104.28,0,0,0,0,0,0,0,0,0,0,0,0,0,0,0
Bajo,No_siniestro,403760,42,2523.76,0,2,1,0,0,0,0,3,0,0,0,0,0,0,0
Bajo,No_siniestro,409432,5,1362.94,0,0,0,0,0,0,0,0,0,0,0,0,0,0,0
Bajo,No_siniestro,411235,0,251.82,0,0,0,0,0,0,0,0,0,0,0,0,0,0,0
Bajo,No_siniestro,416571,3,1029.68,0,0,0,0,0,0,0,0,0,0,0,0,0,0,0
Bajo,No_siniestro,417592,3,213.24,0,0,0,0,0,0,0,0,0,0,0,0,0,0,0
Bajo,No_siniestro,419826,5,370.43,0,0,0,0,0,0,0,0,0,0,0,0,0,0,0
Bajo,No_siniestro,420078,0,5329.53,0,0,0,0,0,0,0,0,0,0,0,0,0,0,0
Bajo,No_siniestro,424030,42,2974.48,0,0,0,0,0,0,0,0,0,0,0,0,0,0,0
Bajo,No_siniestro,424558,62,379.09,0,0,0,0,0,0,0,0,0,0,0,0,0,0,0
Bajo,No_siniestro,427163,93,649.97,0,1,1,2,1,0,0,5,0,0,0,0,0,0,0
Bajo,No_siniestro,430302,0,1153.75,0,0,0,0,0,0,0,0,0,0,0,0,0,0,0
Bajo,No_siniestro,430591,1,116.54,0,0,0,0,0,0,0,0,0,0,0,0,0,0,0
Bajo,No_siniestro,434050,42,1623.44,0,0,0,0,0,0,0,0,0,0,0,0,0,0,0
Bajo,No_siniestro,434883,5,919.53,0,3,2,1,0,0,0,6,0,0,0,0,0,0,0
Bajo,No_siniestro,435287,2,1141.5,0,0,0,0,0,0,0,0,0,0,0,0,0,0,0
Bajo,No_siniestro,437524,0,0,0,0,0,0,0,0,0,0,0,0,0,0,0,0,0
Bajo,No_siniestro,438178,3,502.86,0,0,0,0,0,0,0,0,0,0,0,0,0,0,0
Bajo,No_siniestro,438494,1,312.38,0,0,0,0,0,0,0,0,0,0,0,0,0,0,0
Bajo,No_siniestro,442460,42,0,0,0,0,0,0,0,0,0,0,0,0,0,0,0,0
Bajo,No_siniestro,442882,2,1566.33,0,0,0,0,0,0,0,0,0,0,0,0,0,0,0
Bajo,No_siniestro,443074,2,0,0,0,0,0,0,0,0,0,0,0,0,0,0,0,0
Bajo,No_siniestro,443137,3,1347.5,0,0,0,0,0,0,0,0,0,0,0,0,0,0,0
Bajo,No_siniestro,443368,4,0,0,0,0,0,0,0,0,0,0,0,0,0,0,0,0
Bajo,No_siniestro,443540,42,360.82,0,0,0,1,0,0,0,1,0,0,0,0,0,0,0
Bajo,No_siniestro,443556,4,372.86,0,0,0,0,0,0,0,0,0,0,0,0,0,0,0
Bajo,No_siniestro,444691,28,317.26,0,0,0,0,1,0,0,1,0,0,0,0,0,0,0
Bajo,No_siniestro,444951,42,0,0,0,0,0,0,0,0,0,0,0,0,0,0,0,0
Bajo,No_siniestro,449196,1,779.04,0,0,0,0,0,0,0,0,0,0,0,0,0,0,0
Bajo,No_siniestro,451062,15,484.72,0,0,0,0,0,0,0,0,0,0,0,0,0,0,0
Bajo,No_siniestro,453166,1,0,0,0,0,0,0,0,0,0,0,0,0,0,0,0,0
Bajo,No_siniestro,463900,42,943.59,0,0,0,0,0,0,0,0,0,0,0,0,0,0,0
Bajo,No_siniestro,464079,2,2311.85,0,1,0,0,0,0,0,1,0,0,0,0,0,0,0
Bajo,No_siniestro,464256,7,193.31,0,0,0,0,0,0,0,0,0,0,0,0,0,0,0
Bajo,No_siniestro,464636,53,1518.39,0,0,0,0,0,0,0,0,0,0,0,0,0,0,0
Bajo,No_siniestro,465347,4,1463.68,0,0,0,0,0,0,0,0,0,0,0,0,0,0,0
Bajo,No_siniestro,466065,1,519.93,0,0,0,0,0,0,0,0,0,0,0,0,0,0,0
Bajo,No_siniestro,466066,63,0,0,0,0,0,0,0,0,0,0,0,0,0,0,0,0
Bajo,No_siniestro,468932,21,0,0,0,0,0,0,0,0,0,0,0,0,0,0,0,0
Bajo,No_siniestro,473000,42,0,0,0,0,0,0,0,0,0,0,0,0,0,0,0,0
Bajo,No_siniestro,475306,1,2185.84,0,0,0,0,0,0,0,0,0,0,0,0,0,0,0
Bajo,No_siniestro,480166,46,0,0,0,0,0,0,0,0,0,0,0,0,0,0,0,0
Bajo,No_siniestro,480205,4,297.33,0,1,1,0,0,0,0,2,0,0,0,0,0,0,0
Bajo,No_siniestro,481703,3,1743.92,0,0,0,0,0,0,0,0,0,0,0,0,0,0,0
Bajo,No_siniestro,487891,5,399.67,0,0,0,0,0,0,0,0,0,0,0,0,0,0,0
Bajo,No_siniestro,489239,72,196.5,0,0,0,0,0,0,0,0,0,0,0,0,0,0,0
Bajo,No_siniestro,490882,6,140.91,0,0,0,0,0,0,0,0,0,0,0,0,0,0,0
Bajo,No_siniestro,492739,3,378.43,0,0,0,0,0,0,0,0,0,0,0,0,0,0,0
Bajo,No_siniestro,494133,15,1532.29,0,0,0,0,0,0,0,0,0,0,0,0,0,0,0
Bajo,No_siniestro,499689,7,731.21,0,0,0,0,0,0,0,0,0,0,0,0,0,0,0
Bajo,No_siniestro,504855,2,191.72,0,0,0,0,0,0,0,0,0,0,0,0,0,0,0
Bajo,No_siniestro,504965,16,1378.36,0,1,0,1,1,1,1,5,0,0,0,0,0,0,0
Bajo,No_siniestro,506574,1,281.24,0,0,0,0,0,0,0,0,0,0,0,0,0,0,0
Bajo,No_siniestro,508322,0,962.5,0,0,0,0,0,0,0,0,0,0,0,0,0,0,0
Bajo,No_siniestro,509911,3,389.12,0,0,0,0,0,0,0,0,0,0,0,0,0,0,0
Bajo,No_siniestro,513123,5,1459.66,0,1,0,0,0,0,0,1,0,0,0,0,0,0,0
Bajo,No_siniestro,514752,2,588.79,0,0,1,0,0,0,0,1,0,0,0,0,0,0,0
Bajo,No_siniestro,522482,3,620.55,0,0,0,0,0,0,0,0,0,0,0,0,0,0,0
Bajo,No_siniestro,522863,9,78.28,0,0,0,0,0,0,0,0,0,0,0,0,0,0,0
Bajo,No_siniestro,523651,5,0,0,0,0,0,0,0,0,0,0,0,0,0,0,0,0
Bajo,No_siniestro,528949,3,3650.71,0,0,0,0,0,0,0,0,0,0,0,0,0,0,0
Bajo,No_siniestro,529504,36,967.45,0,0,0,0,0,0,0,0,0,0,0,0,0,0,0
Bajo,No_siniestro,532022,5,1226.68,0,0,0,0,0,0,0,0,0,0,0,0,0,0,0
Bajo,No_siniestro,534207,18,0,0,0,0,0,0,0,0,0,0,0,0,0,0,0,0
Bajo,No_siniestro,534757,13,2146.09,0,0,0,0,0,0,0,0,0,0,0,0,0,0,0
Bajo,No_siniestro,535853,4,11396.05,0,0,0,0,0,0,0,0,0,0,0,0,0,0,0
Bajo,No_siniestro,536976,0,960.02,0,0,0,0,0,0,0,0,0,0,0,0,0,0,0
Bajo,No_siniestro,545545,94,0,0,0,0,0,0,0,0,0,0,0,0,0,0,0,0
Bajo,No_siniestro,545565,4,1031.39,0,0,0,0,0,0,0,0,0,0,0,0,0,0,0
Bajo,No_siniestro,550029,5,659.33,0,0,0,0,0,0,0,0,0,0,0,0,0,0,0
Bajo,No_siniestro,553422,8,926.3,0,0,0,0,0,0,0,0,0,0,0,0,0,0,0
Bajo,No_siniestro,554841,106,1094.26,0,0,0,0,1,0,0,1,0,0,0,0,0,0,0
Bajo,No_siniestro,555880,42,1310.64,0,0,0,0,0,0,0,0,0,0,0,0,0,0,0
Bajo,No_siniestro,558867,3,0,0,0,0,0,0,0,0,0,0,0,0,0,0,0,0
Bajo,No_siniestro,559236,1,675.21,0,0,0,0,0,0,0,0,0,0,0,0,0,0,0
Bajo,No_siniestro,560523,6,9.65,0,0,0,0,0,0,0,0,0,0,0,0,0,0,0
Bajo,No_siniestro,564558,29,0,0,0,0,1,0,1,0,2,0,0,0,0,0,0,0
Bajo,No_siniestro,568146,17,46.15,0,0,0,0,0,0,0,0,0,0,0,0,0,0,0
Bajo,No_siniestro,569621,6,13.53,0,0,0,0,0,0,0,0,0,0,0,0,0,0,0
Bajo,No_siniestro,571812,1,413.24,0,0,0,0,0,0,0,0,0,0,0,0,0,0,0
Bajo,No_siniestro,573028,7,0,0,0,0,0,0,0,0,0,0,0,0,0,0,0,0
Bajo,No_siniestro,576581,12,69.65,0,0,0,0,0,0,0,0,0,0,0,0,0,0,0
Bajo,No_siniestro,576761,1,95.56,0,0,0,0,0,0,0,0,0,0,0,0,0,0,0
Bajo,No_siniestro,576963,6,2270.91,0,0,0,0,0,0,0,0,0,0,0,0,0,0,0
Bajo,No_siniestro,577922,88,0,0,0,0,0,0,0,0,0,0,0,0,0,0,0,0
Bajo,No_siniestro,579837,4,1001.65,0,0,0,0,0,0,0,0,0,0,0,0,0,0,0
Bajo,No_siniestro,580456,3,1407.78,0,0,0,0,0,0,0,0,0,0,0,0,0,0,0
Bajo,No_siniestro,580788,2,974.54,0,0,0,0,0,0,0,0,0,0,0,0,0,0,0
Bajo,No_siniestro,582348,2,1660.87,0,0,0,0,0,0,0,0,0,0,0,0,0,0,0
Bajo,No_siniestro,586928,5,908.99,0,0,0,0,0,0,0,0,0,0,0,0,0,0,0
Bajo,No_siniestro,593329,2,2604.27,0,0,0,0,0,0,0,0,0,0,0,0,0,0,0
Bajo,No_siniestro,595293,10,10692.66,0,0,0,0,0,0,0,0,0,0,0,0,0,0,0
Bajo,No_siniestro,596488,2,1033.35,0,0,0,0,0,0,0,0,0,0,0,0,0,0,0
Bajo,No_siniestro,598942,0,864.51,0,0,0,0,0,0,0,0,0,0,0,0,0,0,0
Bajo,No_siniestro,602139,3,1942.56,0,0,0,0,0,0,0,0,0,0,0,0,0,0,0
Bajo,No_siniestro,603131,13,849.81,0,0,0,0,0,0,0,0,0,0,0,0,0,0,0
Bajo,No_siniestro,603160,42,0,0,0,0,0,0,0,0,0,0,0,0,0,0,0,0
Bajo,No_siniestro,603421,7,0,0,0,0,0,0,0,0,0,0,0,0,0,0,0,0
Bajo,No_siniestro,608765,8,453.66,0,0,0,0,0,0,0,0,0,0,0,0,0,0,0
Bajo,No_siniestro,610224,20,358.24,0,0,0,0,0,0,1,1,0,0,0,0,0,0,0
Bajo,No_siniestro,615021,59,0,0,0,0,0,0,0,0,0,0,0,0,0,0,0,0
Bajo,No_siniestro,616356,3,583.35,0,0,0,0,0,0,0,0,0,0,0,0,0,0,0
Bajo,No_siniestro,616404,1,0,0,0,0,0,0,0,0,0,0,0,0,0,0,0,0
Bajo,No_siniestro,624064,127,0,0,0,0,0,0,0,0,0,0,0,0,0,0,0,0
Bajo,No_siniestro,625466,4,0,0,0,0,0,0,0,0,0,0,0,0,0,0,0,0
Bajo,No_siniestro,629010,42,0,0,0,0,0,0,0,0,0,0,0,0,0,0,0,0
Bajo,No_siniestro,629341,53,2424.17,0,0,0,0,0,0,0,0,0,0,0,0,0,0,0
Bajo,No_siniestro,630941,1,0,0,0,0,0,0,0,0,0,0,0,0,0,0,0,0
Bajo,No_siniestro,632601,5,886.17,0,0,0,0,0,0,0,0,0,0,0,0,0,0,0
Bajo,No_siniestro,637981,5,1527.1,0,0,0,0,0,0,0,0,0,0,0,0,0,0,0
Bajo,No_siniestro,640654,8,509.75,0,0,0,0,0,0,0,0,0,0,0,0,0,0,0
Bajo,No_siniestro,644163,4,517.82,0,0,0,0,0,0,0,0,0,0,0,0,0,0,0
Bajo,No_siniestro,644283,0,1438,0,0,0,0,0,0,0,0,0,0,0,0,0,0,0
Bajo,No_siniestro,644304,3,0.3,0,0,0,0,0,0,0,0,0,0,0,0,0,0,0
Bajo,No_siniestro,644923,0,0,0,0,0,0,0,0,0,0,0,0,0,0,0,0,0
Bajo,No_siniestro,649511,5,412.57,0,0,0,0,0,0,0,0,0,0,0,0,0,0,0
Bajo,No_siniestro,649603,3,1028.72,0,0,0,0,0,0,0,0,0,0,0,0,0,0,0
Bajo,No_siniestro,649825,8,1890.43,0,0,1,0,0,0,0,1,0,0,0,0,0,0,0
Bajo,No_siniestro,651984,15,129.86,0,0,0,0,0,0,0,0,0,0,0,0,0,0,0
Bajo,No_siniestro,659256,0,2289.68,0,0,0,0,0,0,0,0,0,0,0,0,0,0,0
Bajo,No_siniestro,665336,14,920.6,0,0,0,0,0,0,0,0,0,0,0,0,0,0,0
Bajo,No_siniestro,667055,20,546.28,0,0,0,0,0,0,0,0,0,0,0,0,0,0,0
Bajo,No_siniestro,667181,1,498.54,0,0,0,0,0,0,0,0,0,0,0,0,0,0,0
Bajo,No_siniestro,668087,4,445.01,0,0,0,0,0,0,0,0,0,0,0,0,0,0,0
Bajo,No_siniestro,671954,4,1347.63,0,0,0,0,0,0,0,0,0,0,0,0,0,0,0
Bajo,No_siniestro,676142,3,0,0,0,0,0,0,0,0,0,0,0,0,0,0,0,0
Bajo,No_siniestro,677976,2,0,0,0,0,0,0,0,0,0,0,0,0,0,0,0,0
Bajo,No_siniestro,679563,3,534.94,0,0,0,0,0,0,0,0,0,0,0,0,0,0,0
Bajo,No_siniestro,679797,125,0,0,0,0,0,0,0,0,0,0,0,0,0,0,0,0
Bajo,No_siniestro,682279,4,150.25,0,0,0,0,0,0,0,0,0,0,0,0,0,0,0
Bajo,No_siniestro,683531,5,1141.77,0,0,0,0,0,0,0,0,0,0,0,0,0,0,0
Bajo,No_siniestro,692358,1,204.14,0,0,0,0,0,0,0,0,0,0,0,0,0,0,0
Bajo,No_siniestro,692441,85,0,0,0,0,0,0,0,0,0,0,0,0,0,0,0,0
Bajo,No_siniestro,698162,5,316.53,0,0,0,0,0,0,0,0,0,0,0,0,0,0,0
Bajo,No_siniestro,698502,1,1949.55,0,0,0,0,0,0,0,0,0,0,0,0,0,0,0
Bajo,No_siniestro,702644,50,0,0,0,0,0,0,0,0,0,0,0,0,0,0,0,0
Bajo,No_siniestro,708186,92,0,0,0,0,0,0,0,0,0,0,0,0,0,0,0,0
Bajo,No_siniestro,709800,42,151.36,0,0,0,0,0,0,0,0,0,0,0,0,0,0,0
Bajo,No_siniestro,710455,2,6579.24,0,0,0,0,0,0,0,0,0,0,0,0,0,0,0
Bajo,No_siniestro,711029,1,1992.25,0,0,0,0,0,0,0,0,0,0,0,0,0,0,0
Bajo,No_siniestro,715749,49,0,0,0,0,0,0,0,0,0,0,0,0,0,0,0,0
Bajo,No_siniestro,716910,42,427.37,0,0,0,0,0,0,0,0,0,0,0,0,0,0,0
Bajo,No_siniestro,717764,8,0,0,0,0,0,0,0,0,0,0,0,0,0,0,0,0
Bajo,No_siniestro,718536,13,763.03,0,0,0,1,0,0,0,1,0,0,0,0,0,0,0
Bajo,No_siniestro,718647,1,214,0,1,0,0,0,0,0,1,0,0,0,0,0,0,0
Bajo,No_siniestro,719903,1,751.59,0,0,0,0,0,0,0,0,0,0,0,0,0,0,0
Bajo,No_siniestro,724732,20,0,0,0,0,0,0,0,0,0,0,0,0,0,0,0,0
Bajo,No_siniestro,725866,46,0,0,0,0,0,0,0,0,0,0,0,0,0,0,0,0
Bajo,No_siniestro,734700,42,1573.01,0,0,0,0,0,0,0,0,0,0,0,0,0,0,0
Bajo,No_siniestro,735342,22,625.4,0,0,0,0,0,0,0,0,0,0,0,0,0,0,0
Bajo,No_siniestro,737042,164,86.22,0,1,1,0,0,0,0,2,0,0,0,0,0,0,0
Bajo,No_siniestro,738549,19,529.24,0,0,0,0,0,0,0,0,0,0,0,0,0,0,0
Bajo,No_siniestro,744009,98,0,0,0,0,0,0,0,0,0,0,0,0,0,0,0,0
Bajo,No_siniestro,745074,6,867.92,0,0,0,0,0,1,0,1,0,0,0,0,0,0,0
Bajo,No_siniestro,747842,11,161.69,0,0,0,0,0,0,0,0,0,0,0,0,0,0,0
Bajo,No_siniestro,749669,106,335.07,0,0,0,1,0,0,0,1,0,0,0,0,0,0,0
Bajo,No_siniestro,750290,42,0,0,0,0,0,0,0,0,0,0,0,0,0,0,0,0
Bajo,No_siniestro,756288,59,0,0,0,0,0,0,0,0,0,0,0,0,0,0,0,0
Bajo,No_siniestro,756480,42,0,0,0,0,0,0,0,0,0,0,0,0,0,0,0,0
Bajo,No_siniestro,756994,5,4486.08,0,0,0,0,0,0,0,0,0,0,0,0,0,0,0
Bajo,No_siniestro,759540,42,711.47,0,1,1,1,1,1,0,5,0,0,0,0,0,0,0
Bajo,No_siniestro,760739,9,0,0,0,0,0,0,0,0,0,0,0,0,0,0,0,0
Bajo,No_siniestro,762776,4,0,0,0,0,0,0,0,0,0,0,0,0,0,0,0,0
Bajo,No_siniestro,762959,27,315.05,0,2,1,0,0,0,0,3,0,0,0,0,0,0,0
Bajo,No_siniestro,764823,9,0,0,0,0,0,0,0,0,0,0,0,0,0,0,0,0
Bajo,No_siniestro,767798,3,844.18,0,0,0,0,0,0,0,0,0,0,0,0,0,0,0
Bajo,No_siniestro,767824,0,1787.52,0,0,0,0,0,0,0,0,0,0,0,0,0,0,0
Bajo,No_siniestro,770434,10,407.37,0,0,0,0,0,0,0,0,0,0,0,0,0,0,0
Bajo,No_siniestro,771560,42,430.76,0,1,0,0,0,0,1,2,0,0,0,0,0,0,0
Bajo,No_siniestro,774079,30,753.51,0,1,0,0,0,1,0,2,0,0,0,0,0,0,0
Bajo,No_siniestro,775677,6,0,0,0,0,0,0,0,0,0,0,0,0,0,0,0,0
Bajo,No_siniestro,776631,109,0,0,0,0,0,0,0,0,0,0,0,0,0,0,0,0
Bajo,No_siniestro,779794,9,0,0,0,0,0,0,0,0,0,0,0,0,0,0,0,0
Bajo,No_siniestro,780669,4,1032.41,0,0,0,0,0,0,0,0,0,0,0,0,0,0,0
Bajo,No_siniestro,782656,10,283.43,0,0,0,0,0,0,0,0,0,0,0,0,0,0,0
Bajo,No_siniestro,786534,1,141.21,0,0,0,0,0,0,0,0,0,0,0,0,0,0,0
Bajo,No_siniestro,789498,5,931.5,0,0,0,0,0,0,0,0,0,0,0,0,0,0,0
Bajo,No_siniestro,789697,13,0,0,0,0,0,0,0,0,0,0,0,0,0,0,0,0
Bajo,No_siniestro,789964,2,2196.94,0,0,0,0,0,0,0,0,0,0,0,0,0,0,0
Bajo,No_siniestro,790551,4,1261.59,0,0,0,0,0,0,0,0,0,0,0,0,0,0,0
Alto,No_siniestro,1652,168,335.69,0,0,0,0,0,0,0,0,0,0,0,0,0,0,0
Alto,No_siniestro,5153,255,1210,0,0,0,0,0,0,0,0,0,0,0,0,0,0,0
Alto,No_siniestro,19841,95,917.34,22260.14,0,0,1,0,0,0,1,0,0,0,0,0,0,0
Alto,No_siniestro,29809,201,13758.93,38382.93,0,0,1,0,0,0,1,0,0,0,0,0,0,0
Alto,No_siniestro,34288,44,2015.02,211659.82,0,0,0,0,0,0,0,0,0,0,0,0,0,0
Alto,No_siniestro,60697,77,903.25,0,0,0,0,0,0,0,0,0,0,0,0,0,0,0
Alto,No_siniestro,66746,107,5049.78,14801.07,0,0,0,0,0,0,0,0,0,0,0,0,0,0
Alto,No_siniestro,67165,98,206.44,44554.36,0,0,0,0,0,0,0,0,0,0,0,0,0,0
Alto,No_siniestro,74027,91,988.49,0,0,0,0,0,0,0,0,0,0,0,0,0,0,0
Alto,No_siniestro,78265,100,44.1,0,0,0,0,0,0,0,0,0,0,0,0,0,0,0
Alto,No_siniestro,124768,27,57.65,0,0,0,0,0,0,0,0,0,0,0,0,0,0,0
Alto,No_siniestro,127165,224,3216.51,0,0,0,0,0,0,0,0,0,0,0,0,0,0,0
Alto,No_siniestro,198949,114,6549.48,0,0,0,0,0,1,0,1,0,0,0,0,0,0,0
Alto,No_siniestro,204094,168,1508.4,0,0,0,0,0,0,0,0,0,0,0,0,0,0,0
Alto,No_siniestro,206978,78,25714.32,0,0,0,0,0,0,0,0,0,0,0,0,0,0,0
Alto,No_siniestro,251606,31,329.02,0,0,0,0,0,0,0,0,0,0,0,0,0,0,0
Alto,No_siniestro,255818,57,4686.7,0,0,0,0,0,0,0,0,0,0,0,0,0,0,0
Alto,No_siniestro,270484,88,2981.43,0,0,1,0,0,1,0,2,0,0,0,0,0,0,0
Alto,No_siniestro,314991,84,936.22,0,0,0,0,0,0,0,0,0,0,0,0,0,0,0
Alto,No_siniestro,319682,77,4332.37,0,0,0,0,0,0,0,0,0,0,0,0,0,0,0
Alto,No_siniestro,329766,82,271.27,0,0,0,0,0,0,0,0,0,0,0,0,0,0,0
Alto,No_siniestro,333235,124,7621.23,0,0,0,0,0,0,0,0,0,0,0,0,0,0,0
Alto,No_siniestro,357065,8,1891.65,0,0,0,0,0,0,0,0,0,0,0,0,0,0,0
Alto,No_siniestro,374680,44,3410.84,0,0,0,0,0,0,0,0,0,0,0,0,0,0,0
Alto,No_siniestro,381279,61,5283.21,0,0,0,0,0,0,0,0,0,0,0,0,0,0,0
Alto,No_siniestro,387871,43,715.8,0,0,0,0,0,0,0,0,0,0,0,0,0,0,0
Alto,No_siniestro,390516,104,2660.97,0,0,0,0,0,0,0,0,0,0,0,0,0,0,0
Alto,No_siniestro,448959,98,8459.49,0,0,0,0,0,0,0,0,0,0,0,0,0,0,0
Alto,No_siniestro,451146,158,3750.46,0,0,0,0,0,0,0,0,0,0,0,0,0,0,0
Alto,No_siniestro,471987,42,482.9,0,0,0,0,0,0,0,0,0,0,0,0,0,0,0
Alto,No_siniestro,517971,43,4366.12,0,0,0,0,0,0,0,0,0,0,0,0,0,0,0
Alto,No_siniestro,522840,40,16642.23,36645.79,0,0,0,0,0,0,0,0,0,0,0,0,0,0
Alto,No_siniestro,524597,70,459.02,195667.42,0,0,0,0,0,0,0,0,0,0,0,0,0,0
Alto,No_siniestro,545945,128,6311.93,202663.27,0,0,0,0,0,0,0,0,0,0,0,0,0,0
Alto,No_siniestro,546413,20,4917.04,0,0,0,0,0,0,0,0,0,0,0,0,0,0,0
Alto,No_siniestro,549911,134,447.78,292057.3,0,0,0,0,0,0,0,0,0,0,0,0,0,0
Alto,No_siniestro,552034,46,2701.93,0,0,0,0,0,0,0,0,0,0,0,0,0,0,0
Alto,No_siniestro,583286,41,2091.78,0,0,0,0,0,0,0,0,0,0,0,0,0,0,0
Alto,No_siniestro,586984,189,2076.04,42024.41,0,0,0,0,0,0,0,0,0,0,0,0,0,0
Alto,No_siniestro,588249,160,1906.39,0,0,0,0,0,0,0,0,0,0,0,0,0,0,0
Alto,No_siniestro,591221,103,7032.51,0,0,0,0,0,0,0,0,0,0,0,0,0,0,0
Alto,No_siniestro,600320,40,2235.98,0,0,0,0,0,0,0,0,0,0,0,0,0,0,0
Alto,No_siniestro,650159,7,184.76,0,0,0,0,0,0,0,0,0,0,0,0,0,0,0
Alto,No_siniestro,651676,35,441.24,0,0,0,0,0,0,0,0,0,0,0,0,0,0,0
Alto,No_siniestro,655534,79,2107.52,0,0,0,0,0,0,0,0,0,0,0,0,0,0,0
Alto,No_siniestro,656508,80,1.16,0,0,0,0,0,0,0,0,0,0,0,0,0,0,0
Alto,No_siniestro,664106,222,969.21,0,0,0,0,0,0,0,0,0,0,0,0,0,0,0
Alto,No_siniestro,734182,233,20022.59,0,0,0,0,0,0,0,0,0,0,0,0,0,0,0
Alto,No_siniestro,741687,57,840.49,60210.75,0,0,0,0,0,0,0,0,0,0,0,0,0,0
Alto,No_siniestro,743314,37,232.59,0,0,0,0,0,0,0,0,0,0,0,0,0,0,0
Alto,No_siniestro,745141,46,11281.86,276187.59,0,0,0,0,0,0,0,0,0,0,0,0,0,0
Alto,No_siniestro,107927,34,0,0,0,0,0,0,0,0,0,0,0,0,0,0,0,0
Alto,No_siniestro,251795,40,615.66,0,0,0,0,0,0,0,0,0,0,0,0,0,0,0
Alto,No_siniestro,290764,89,0,0,0,0,0,0,0,0,0,0,0,0,0,0,0,0
